0-ad	リアルタイムストラテジーゲーム
010-editor	テキストエディタ
115browser	ウェブブラウザ
1clipboard	クリップボード管理アプリ
1password	すべてのパスワードを1つのパスワードの背後で安全に保つパスワードマネージャー
1password-cli	1Passwordパスワードマネージャーのコマンドラインヘルパー
360safe	保護とウイルス対策のセキュリティ
3dgenceslicer	3DGenceプリンターのCADモデルに基づいて3D印刷用のファイルを準備します
4k-slideshow-maker	スライドショーメーカー
4k-stogram	Instagramの写真、アカウント、ハッシュタグ、場所をダウンロードする
4k-video-downloader	無料のビデオダウンローダー
4k-video-to-mp3	ビデオをMP3に変換する
4k-youtube-to-mp3	YouTubeリンクをMP3ファイルに変換する
4peaks	DNA配列トレースファイルの視覚化と編集
5kplayer	品質を損なうことなく、4K/1080p/360° ビデオ、MP3 AAC APEFLAC音楽を再生します
7777	ローカルポート7777のリモートAWSデータベース
8bitdo-ultimate-software	コントローラーのすべての部分を制御する
8x8-meet	ビデオ会議プラットフォーム
8x8-work	音声、ビデオ、チャット、およびWeb会議を備えたコミュニケーションアプリケーション
a-better-finder-attributes	ファイルと写真の微調整ツール
a-better-finder-rename	ファイル、音楽、写真の名前変更
a-slower-speed-of-light	一人称ゲーム
ableton-live-intro	サウンドと音楽のエディター
ableton-live-lite	サウンドと音楽のエディター
ableton-live-standard	サウンドと音楽のエディター
ableton-live-suite	サウンドと音楽のエディター
abricotine	インラインプレビュー付きのマークダウンエディタ
abscissa	プロットソフトウェア
abstract	スケッチファイルをサポートするコラボレーションデザインツール
abyssoft-teleport	仮想KVM
accessmenubarapps	メニューバーアプリへの即時アクセス
accordance	聖書研究ソフトウェア
accurics	コードとしてのインフラストラクチャのセキュリティとコンプライアンス
ace-link	VLCプレーヤーでエースストリームビデオストリームを再生できるメニューバーアプリ
acorn	シンプルさに焦点を当てた画像エディタ
acousticbrainz-gui	オーディオ機能をAcousticBrainzデータベースに送信するためのグラフィカルクライアント
acquia-dev	Drupalサイトをローカルにインストール、テスト、および構築する
acronis-true-image	フルイメージのバックアップおよびクローン作成ソフトウェア
acslogo	ロゴ通訳
activedock	カスタマイズ可能なドック、アプリケーションランチャー、ドックの交換
activitywatch	タイムトラッカー
actual	あなたの財政を管理するためのプライバシーに焦点を当てたアプリ
actual-odbc-pack	実際のODBCドライバーパック
adapter	ビデオ、オーディオ、画像を変換します
adguard	スタンドアロンの広告ブロッカー
adguard-vpn	プライバシーとセキュリティのためのVPN
adium	インスタントメッセージングアプリケーション
adobe-acrobat-pro	ポータブルドキュメント形式のファイルを表示、作成、操作、印刷、および管理します
adobe-acrobat-reader	PDFドキュメントの表示、印刷、およびコメント
adobe-air	アプリケーションやゲームの開発に使用されるフレームワーク
adobe-connect	仮想会議クライアント
adobe-creative-cloud	写真、デザイン、ビデオ、ウェブ、UX向けのアプリとサービスのコレクション
adobe-creative-cloud-cleaner-tool	アドビソフトウェアの破損したインストールをクリーンアップするユーティリティ
adobe-digital-editions	電子書籍リーダー
adobe-dng-converter	DNGファイルコンバーター
adoptopenjdk	Javaユーザーグループ（JUG）のJDK
adrive	Alibaba Cloud Disk 
advancedrestclient	APIテストツール
aegisub	字幕の作成と変更
aerial	AppleTV空中スクリーンセーバー
aether	ピアツーピアの一時的なパブリックコミュニティ
aexol-remote-mouse	Aexolリモートマウス
affinity-designer	プロのグラフィックデザインソフトウェア
affinity-photo	プロの画像編集ソフトウェア
affinity-publisher	プロのデスクトップパブリッシングソフトウェア
after-dark-classic	ダーククラシックセット後
agenda	日付に焦点を当てたアプリケーションを取ることに注意してください
aimersoft-video-converter-ultimate	ビデオコンバーターアプリ
air-video-server-hd	Appleデバイスにビデオをストリーミングするためのツール
airbuddy	AirPodsコンパニオンアプリ
aircall	クラウドベースのコールセンターと電話システムソフトウェア
airdisplay	タブレットをセカンドモニターとして使用するためのユーティリティ
airdroid	モバイルデバイス管理スイート
airflow	AppleTVとChromecastでローカルコンテンツを見る
airfoil	コンピューターから出力にオーディオを送信します
airmedia	タッチレスプレゼンテーションおよびコラボレーションソフトウェア
airparrot	画面をワイヤレスでミラーリングしたり、メディアファイルをストリーミングしたりするためのツール
airpass	時間に制約のあるWiFiネットワークを克服するためのステータスバーアプリ
airserver	スクリーンミラーリングレシーバー
airtable	スプレッドシートとデータベースのハイブリッドクラウドコラボレーション
airtame	ワイヤレス画面共有プラットフォーム
airtool	Wi-Fiパケットをキャプチャする
airtrash	AppleのAirdropのクローン-簡単なP2Pファイル転送
airunlock	Bluetooth経由でAndroid携帯を使用してMacBookをロックまたはロック解除するツール
airy	YouTubeビデオとMP3ダウンローダー
ajour	World ofWarcraftアドオンマネージャー
alacritty	GPUで高速化されたターミナルエミュレータ
aladin	インタラクティブスカイアトラス
alchemy	図面プロジェクトを開く
aldente	最大充電率を制限するメニューバーツール
aleph-one	Bungie窶冱Marathon2ゲームエンジンのオープンソース継続
alfaview	オーディオビデオ会議
alfred	アプリケーションランチャーと生産性ソフトウェア
algodoo	物理システムを描画して操作する
alinof-timer	タイマーアプリ
alipay-development-assistant	Alipayのオープンプラットフォーム開発アシスタント
aliworkbench	マーチャントワークベンチ
all-in-one-messenger	さまざまなメッセージングプラットフォーム用の複合インターフェイス
alloy	ソフトウェアモデリングのためのプログラミング言語
almighty	設定と微調整コンフィギュレーター
alt-c	双方向のテキストコピー
alt-tab	Windowsのようなalt-tabを有効にする
altair-graphql-client	GraphQLクライアント
altdeploy	AltDeploy
alternote	Evernote用のメモ取りアプリ
altserver	iOS AppStoreの代替
alva	コードコンポーネントを使用して生きたプロトタイプを作成する
amadeus-pro	多目的オーディオレコーダー、エディター、コンバーター
amadine	ベクトルグラフィックおよびイラストソフトウェア
amazon-chime	通信サービス
amazon-music	AmazonMusic用のデスクトップクライアント
amazon-photos	写真の保存と共有サービス
amazon-workdocs	完全に管理された安全なコンテンツの作成、保存、およびコラボレーションサービス
amazon-workdocs-drive	完全に管理された安全なエンタープライズストレージおよび共有サービス
amazon-workspaces	クラウドネイティブの永続デスクトップ仮想化
amd-power-gadget	AMDプロセッサ用の電源管理、監視、VirtualSMCプラグイン
amethyst	xmonadに似た自動タイル型ウィンドウマネージャー
amitv87-pip	常にトップウィンドウのプレビュー
amm	Aria2メニューバーモニター
ammonite	タグビジュアライザーと検索ユーティリティ
amorphousdiskmark	ストレージの読み取り/書き込みパフォーマンスを測定するアプリ
ampps	Webサイト開発用のソフトウェアスタック
anaconda	科学計算のためのPythonおよびRプログラミング言語の配布
ananas-analytics-desktop-edition	ハッキング可能なデータ統合および分析ツール
android-commandlinetools	Androidアプリを構築およびデバッグするためのコマンドラインツール
android-file-transfer	Androidスマートフォンとの間でファイルを転送する
android-messages	Androidメッセージ用のデスクトップクライアント
android-ndk	Androidアプリの一部をネイティブコードで実装するためのツールセット
android-platform-tools	AndroidSDKコンポーネント
android-sdk	android-sdk
android-studio	Androidアプリケーションを構築するためのツール
androidtool	画面を記録し、iOSとAndroidにアプリをインストールするためのアプリ
angband	ダンジョン探検ゲーム
angry-ip-scanner	ネットワークスキャナー
anka-build-cloud-controller-and-registry	仮想マシン管理GUI/APIおよびレジストリ
anka-virtualization	仮想マシンを管理および作成するためのCLIツール
ankama	アンカマのPCゲームをダウンロードするためのポータル
anki	記憶力トレーニングアプリケーション
ankiapp-anki	AnkiApp
anonym	ネットワークアクセスアノニマイザー
anonymousvpn	匿名VPN
another-redis-desktop-manager	Redisデスクトップマネージャー
ansible-dk	Ansibleベースのインフラストラクチャコードで作業するためのOmnibusベースのツールキット
antconc	調整およびテキスト分析のためのコーパス分析ツールキット
anybar	メニューバーステータスインジケーター
anydesk	コンピュータへのリモート接続を許可します
anydo	リマインダー、プランナー、カレンダー
anylist	食料品の買い物リスト
ao	エレガントなMicrosoftTo-Doデスクトップアプリ
apache-couchdb	マルチマスター同期データベース
apache-directory-studio	EclipseベースのLDAPブラウザとディレクトリクライアント
apk-icon-editor	APKアイコン、名前、バージョン、その他のデータを変更するためのエディター
app-cleaner	アンインストーラーとクリーニングアシスタント
app-tamer	CPU管理アプリケーション
apparency	アプリケーションバンドルを検査する
appcleaner	アプリケーションアンインストーラ
appcode	Swift、Objective-C、C、およびC++開発用のIDE
appdelete	AppDelete
appflowy	オープンソースプロジェクトと知識管理ツール
appgate-sdp-client	安全なネットワークアクセスのためのソフトウェア定義の境界
appgrid	Vimのようなホットキーを備えたウィンドウマネージャー
appium	Appium自動化サーバーへのグラフィカルフロントエンド
appium-inspector	モバイルアプリのGUIインスペクター
apple-events	非公式のAppleイベントアプリ
apple-juice	バッテリー残量などを表示するバッテリーゲージ
applepi-baker	SDカード、USBドライブ、外付けHDDなどのバックアップと復元
apppolice	実行中のプロセスのCPU使用率をすばやく制限するためのアプリ
appstore-quickview	アプリ...Store クイックビュー
apptivate	Apptivate
apptrap	AppTrap
appzapper	不要なアプリケーションとそのサポートファイルをアンインストールするツール
aptanastudio	Aptana Studio
aptible	監査対応のAppDeploymentプラットフォームであるAptibleDeployのコマンドラインツール
aqua-data-studio	データ管理と視覚分析を備えたデータベースIDE
aquamacs	GNUEmacsに基づくテキストエディタ
aquaskk	AquaSKK
aquaterm	Grahicsレンダラー
araxis-merge	2方向および3方向のファイル比較、マージ、およびフォルダー同期
archipelago	Webテクノロジに基づいて構築されたターミナルエミュレータ
archiver	アーカイブを開き、ファイルを圧縮し、ファイルを分割して結合します
arctype	SQLクライアントおよびデータベース管理ツール
arduino	エレクトロニクスプロトタイピングプラットフォーム
aria-maestosa	MIDIシーケンサーおよびエディター
aria2d	Aria2 GUI
aria2gui	Aria2のグラフィカルユーザーインターフェイス
ariang	AriaNgよりも優れたaria2デスクトップフロントエンド
ark-desktop-wallet	マルチプラットフォームARKデスクトップウォレット
arkiwi	ファイルアーカイバ
armory	Pythonベースのビットコインソフトウェア
around	エネルギー、アイデア、行動のために設計されたビデオハングアウト
arq	マルチクラウドバックアップアプリケーション
arq-cloud-backup	Arqクラウドバックアップ
arrsync	ユーティリティrsyncのグラフィカルフロントエンド
artisan	コーヒー焙煎業者の視覚的範囲
artpip	厳選された写真のデスクトップの背景
asana	チームプロジェクトとタスクを管理する
ascension	ANSI/ASCIIアートビューア
asciidocfx	書籍、ドキュメント、スライドを作成するためのAsciidocエディターとツールチェーン
asset-catalog-tinkerer	.carファイルから画像を参照/抽出します
assinador-serpro	デジタル証明書を使用してドキュメントを検証および署名します
astah-professional	ソフトウェアモデリングツール
astah-uml	マインドマッピングを備えたUML作図ツール
astro-command-center	ASTROコマンドセンター
astropad	iPadを描画タブレットに変えるユーティリティ
astropad-studio	iPadをプロの描画タブレットに変えましょう
atemosc	OSCでBMDATEMビデオスイッチャーを制御する
atext	入力中に略語を置き換えるツール
athens	自己ホスト型知識グラフ
atlantis	MUD（マルチユーザーダンジョン）クライアント
atlauncher	マインクラフトランチャー
atok	JustSystemsが作成した日本語入力方式エディター（IME）
atom	テキストエディタ
atomic-wallet	ビットコイン、イーサリアム、XRP、ライトコイン、XLM、その他300以上のコインとトークンを管理する
au-lab	デジタルオーディオミキシングアプリケーション
audacity	マルチトラックオーディオエディタおよびレコーダー
audio-hijack	任意のアプリケーションからのオーディオを録音します
audiobook-builder	オーディオCDとファイルをオーディオブックに変える
audiogridder-plugin	VST2/VST3/AU/AAXDSPサーバープラグイン
audiogridder-server	VST2/VST3/AUDSPサーバー
audioscrobbler	最小限の堅牢なiTunesのスクロブリング
audioslicer	オーディオファイル内のすべての無音を検索します
audirvana	オーディオ再生ソフトウェア
audius	音楽ストリーミングおよび共有プラットフォーム
augur	AugurUIとugurNodeをバンドルし、ローカルにデプロイするアプリ
aural	Winampに触発されたオーディオプレーヤー
aurora-hdr	フィルタ、バッチ処理などを備えたHDRフォトエディタ
auryo	Soundcloud用の非公式デスクトップアプリ
authy	二要素認証ソフトウェア
autodesk-fusion360	Autodesk Fusion 360
autodmg	システムインストーラーからデプロイ可能なシステムイメージを作成するためのアプリ
autofirma	デジタル署名エディターおよびバリデーター
automute	現在のWi-Fiネットワークに基づいてシステムをミュートまたはミュート解除します
autopkgr	AutoPkgをインストールして構成します
autovolume	音量を指定した音量に自動設定するツール
autumn	秋
avast-secure-browser	プライバシーに焦点を当てたWebブラウザ
avast-security	ウイルス対策ソフト
avg-antivirus	ウイルス対策ソフト
aviatrix-vpn-client	SAML認証を提供するVPNクライアント
avibrazil-rdm	Retinaディスプレイをカスタム解像度に設定するユーティリティ
avidcodecsle	MediaComposerのないシステムでAvidコーデックを使用してQuickTimeムービーを使用する
avidemux	動画編集者
avira-antivirus	ウイルス対策およびVPNソフトウェア
avitools	さまざまなビデオファイル処理ツールのグラフィカルインターフェイス
avocode	デザインファイルでのコラボレーション
avogadro	分子エディタおよびビジュアライザー
avtouchbar	タッチバー用のオーディオビジュアライザー
awa	音楽ストリーミングサービス
aware	Aware
awareness	タイムトラッキングアプリケーション
awips-python	AWIPS Python
aws-vault	開発環境でAWSクレデンシャルを安全に保存してアクセスします
aws-vpn-client	AWSリソースに安全にアクセスするためのマネージドクライアントベースのVPNサービス
axure-rp	開発者向けの計画およびプロトタイピングツール
azirevpn	AzireVPN用のオープンソースVPNクライアント
azure-data-studio	SQLServerでの作業を可能にするデータ管理ツール
babeledit	翻訳エディタ
back-in-time	TimeMachineバックアップのコンテンツにアクセスする
backblaze	データのバックアップとストレージサービス
backblaze-downloader	Backblazeで復元されたファイルをより確実にダウンロードする
background-music	バックグラウンドミュージック
backlog	Backlog
backuploupe	TimeMachineの代替GUI
badlion-client	マインクラフトランチャー
baiduinput	Baidu入力方式をインストールします 
baidunetdisk	クラウドストレージサービス
balance-lock	オーディオバランスが左右にドリフトするのを防ぎます
balenaetcher	OSイメージをSDカードとUSBドライブにフラッシュするツール
ballast	オーディオバランスがずれないようにするステータスバーアプリ
balsamiq-wireframes	UIワイヤーフレーミングツール
bandage	Denovoアセンブリグラフをナビゲートするためのバイオインフォマティクスアプリケーション
bankid	電子個人識別システム
banking-4	ドイツの会計ソフトウェア
banksiagui	チェスGUI
banktivity	銀行口座を一か所で管理するアプリ
banshee	マルチメディア管理および再生アプリケーション
baretorrent	BitTorrentクライアント
baritone	メニューバーにあるSpotifyコントロール
barrier	オープンソースのKVMソフトウェア
bartender	メニューバーアイコンオーガナイザー
base	SQLite 3データベースファイルを作成、設計、編集、閲覧するためのアプリ
basecamp	リモートで作業するためのオールインワンツールキット
basictex	完全なTeXLive / MacTeXの代替としてのコンパクトなTeXディストリビューション
batchmod	ファイルとフォルダの権限を操作するためのユーティリティ
bathyscaphe	2チャンネルブラウザ
batteries	すべてのデバイスのバッテリーを追跡する
battery-buddy	メニューバーのデフォルトのバッテリーインジケーターの交換
battery-report	電源装置の技術概要を作成します
battle-net	オンラインゲームプラットフォーム
battlescribe	卓上ウォーゲーマーのための軍隊リスト作成者
baudline	時間頻度ブラウザ
bbc-iplayer-downloads	BBC iPlayerWebサイトからプログラムをダウンロードします
bbedit	テキスト、コード、およびマークアップエディタ
bdash	軽量データ分析のためのシンプルなSQLクライアント
bdinfo	BDInfo
beacon-scanner	iBeacon互換デバイスをスキャンするユーティリティ
beaker-browser	実験的なピアツーピアWebブラウザ
beamer	AppleTVおよびChromecast用のデスクトップキャスト/ストリーミングアプリ
bean	ワードプロセッサ
beardedspice	BeardedSpice
beatunes	曲の分析、検査、再生
bee	Bee
beekeeper-studio	クロスプラットフォームのSQLエディターとデータベース管理アプリ
beeper	Matrixを搭載したユニバーサルチャットアプリ、15の異なるチャットネットワークを統合
beersmith	ビール醸造ソフトウェア
berrycast	スクリーンレコーダー
bespoke	ソフトウェアモジュラーシンセ
bestres	メニューバーから画面の解像度をすばやく変更する
betaflight-configurator	Betaflightファームウェアの構成ツール
betelguese	ジェイルブレイクされたデバイス用のOdysseyra1nインストーラーGUI
better-window-manager	より良いウィンドウマネージャー
betterdiscord-installer	BetterDiscordのインストーラー
betterdummy	カスタム解像度を実現するためのAppleシリコンMac用ダミーディスプレイ
bettertouchtool	入力デバイスをカスタマイズし、コンピューターシステムを自動化するためのツール
betterzip	アーカイブを作成および変更するためのユーティリティ
between	カップルのための関係アプリ
betwixt	ChromeDevToolsネットワークパネルに基づくWebデバッグプロキシ
beyond-compare	ファイルとフォルダを比較する
bfxr	Bfxr
bibdesk	参考文献の編集と管理
big-mean-folder-machine	ファイル/フォルダ管理ユーティリティ
biglybt	Azureusオープンソースプロジェクトに基づくBittorrentクライアント
bilibili	非公式のbilibiliクライアント
bilimini	小さなウィンドウのbilibiliクライアント
billings-pro	請求書、見積もり、見積もり、タイムトラッキング
binance	暗号通貨交換
binary-ninja	リバースエンジニアリングプラットフォーム
bingpaper	Bingの毎日の写真を壁紙として使用します
bino	ビデオプレーヤー
biopassfido	BioPassFIDO2マネージャー
birdfont	フォントエディタ
biscuit	アプリを整理するためのブラウザ
bisq	分散型ビットコイン交換ネットワーク
bit-fiddle	10進数、16進数、2進数、ASCII文字を変換します
bit-slicer	ユニバーサルゲームトレーナー
bitbar	メニューバーに任意のスクリプトまたはプログラムからの出力を表示するユーティリティ
bitcoin-core	ビットコインクライアントとウォレット
bitmessage	P2P通信プロトコル
bitrix24	Bitrix24
bitshares	GUI/BitSharesブロックチェーンのリファレンスウォレット
bitwarden	デスクトップパスワードとログインボールト
bitwig-studio	デジタルオーディオワークステーション
black-ink	クロスワードパズルをダウンロード、解決、印刷
blackhole-16ch	仮想オーディオドライバー
blackhole-2ch	仮想オーディオドライバー
blackhole-64ch	仮想オーディオドライバー
blender	3D作成スイート
blender-benchmark	3Dパフォーマンスベンチマークツール
bleunlock	Bluetooth LowEnergyデバイスの近くを使用してAppleコンピューターをロック/ロック解除します
blheli-configurator	BLHeli Configurator
blink1control	点滅を制御するユーティリティ（1）USB RGB LEDデバイス
blisk	開発者向けブラウザ
blitz	パフォーマンス分析ソフトウェア
blobby-volley2	直接対決のマルチプレイヤー球技
blobsaver	SHSHブロブを自動的に保存するためのGUI
blockbench	ボックスモデルとピクセルアートテクスチャ用の3Dモデルエディタ
blockblock	一般的な永続性の場所を監視します
blockstack	ブロックスタック
blocs	ビジュアルウェブデザインソフトウェア
bloodhound	ドメイン管理者の6度
bloomrpc	GRPCサービス用のGUIクライアント
blu-ray-player	ブルーレイコンテンツ用のプレーヤー
blu-ray-player-pro	ブルーレイプレーヤーソフトウェア
bluefish	オープンソースコードエディタ
bluegriffon	WebおよびEPUBエディター
blueharvest	外付けドライブからメタデータファイルを削除する
bluej	初心者向けに設計されたJava開発環境
bluejeans	デジタルワークプレイス向けのビデオ会議
bluesense	BlueSense
bluesnooze	スリープ状態のコンピュータがBluetoothアクセサリに接続できないようにします
bluestacks	モバイルゲームプラットフォーム
bluetility	Bluetooth LowEnergyブラウザ
bluewallet	ビットコインウォレットとライトニングウォレット
blurred	画面の背景/非アクティブなコンテンツを暗くするユーティリティ
bob	テキスト、画像、手動入力用の翻訳アプリケーション
boinc	科学計算ジョブをダウンロードし、バックグラウンドで目に見えない形で実行します
bome-network	コンピューター間のMIDI接続を作成する
bonitastudiocommunity	ビジネスプロセスの自動化と最適化
bonjeff	ネットワーク上で公開されているBonjourサービスのライブディスプレイを表示します
bonjour-browser	Bonjourブラウザ
bookends	参照管理および参考文献ソフトウェア
bookmacster	ブックマークマネージャー
boom	オーディオ入力を変換します
boom-3d	ボリュームブースターおよびイコライザーソフトウェア
boop	開発者向けのスクリプト可能なスクラッチパッド
boost-note	開発者向けのマークダウンノートエディタ
boostnote	開発者向けのマークダウンエディタ
bootchamp	Boot CampWindowsパーティションを起動するためのメニューバーアプリ
bootstrap-studio	Bootstrapフレームワークを使用したWebサイトの設計とプロトタイプ
bootxchanger	古いMacのブートロゴを変更するユーティリティ
bossa	bossa
bot-framework-emulator	Bot FrameworkSDKで構築されたチャットボットをテストおよびデバッグします
bowtie	カスタマイズ可能なショートカットで音楽を制御する
box-drive	Boxクラウドストレージサービスのクライアント
box-notes	ボックスノート
box-sync	セキュリティに焦点を当てたクラウドベースのコラボレーションおよび管理プラットフォーム
box-tools	Webブラウザから直接ファイルを作成および編集します
boxcryptor	さまざまなクラウドストレージサービスのファイルとフォルダーを暗号化するツール
boxer	DOSゲームエミュレータ
boxofsnoo-fairmount	もともとMetakineからのDVDマウントソフトウェア
boxy-suite	Gmail、カレンダー、Keep、Contactsアプリ
brackets	Web開発用のオープンソースコードエディタ
brain-workshop	脳ワークショップ
brainfm	brain.fm用のデスクトップクライアント
brave-browser	プライバシーに焦点を当てたWebブラウザ
breaktimer	定期的な休憩を管理するためのツール
breitbandmessung	ドイツ連邦ネットワーク庁による公式インターネット速度テスト
brewlet	自作のメニューレットがありません
brewservicesmenubar	自作サービスを開始および停止するためのメニュー項目
brewtarget	brewtarget
bria	ソフトフォンアプリケーション
bricklink-partdesigner	独自のLEGOパーツをデザインする
bricklink-studio	LEGO命令を作成、レンダリング、作成する
bricksmith	ブリックスミス
brightness	ディスプレイとバックライトキーボードの明るさを調整するためのメニューバー項目
brightness-sync	LGUltraFineディスプレイの明るさを同期するユーティリティ
brisk	レーダーを提出するためのアプリ
brisync	外部ディスプレイの明るさを自動的に制御するユーティリティ
brl-cad-mged	BRL-CAD
brook	プロキシ/ VPNクライアント
brooklyn	Appleスペシャルイベントブルックリンで発表されたアニメーションに基づくスクリーンセーバー
browserosaurus	オープンソースのブラウザプロンプター
browserstacklocal	ローカルホストとステージングWebサイトをテストします
btcpayserver-vault	Webアプリケーションがハードウェアウォレットにアクセスできるようにするアプリ
bubo	SpotifyBluetoothヘッドセットリスナー
buckets	予算編成ツール
bugdom	PangeaSoftwareのバグをテーマにした3Dアクション/アドベンチャーゲーム
buildsettingextractor	Xcodeビルド設定エクストラクタ
bunch	自動化ツール
bunqcommunity-bunq	bunqDesktop
burn	CD書き込みアプリケーション
burp-suite	Webセキュリティテストツールキット
burp-suite-professional	Webセキュリティテストツールキット
busycal	柔軟性と信頼性に焦点を当てた予定表ソフトウェア
busycontacts	効率性に焦点を当てたコンタクトマネージャー
butler	カスタマイズ可能な構成でタスクを配置します
butt	ShoutcastおよびIcecastストリーミングクライアント
butter	溶けたidobata.ioクライアント
buttercup	Javascript SecretsVault-マルチプラットフォームデスクトップアプリケーション
bwana	Bwana
bzflag	3Dマルチプレイヤー戦車バトルゲーム
c0re100-qbittorrent	BitTorrentクライアント
cabal	チャットプラットフォームCabal用のデスクトップクライアント
cacher	コードスニペットオーガナイザー
caffeine	システムがスリープ状態になるのを防ぐユーティリティ
cajviewer	CAJクラウドリーディング
cakebrew	Homebrew用のGUIアプリ
cakebrewjs	電子で書かれた自作GUIアプリ
calcservice	サービス対応アプリに計算を入力します
calendar-366	イベントとリマインダーのメニューバーカレンダー
calibre	電子書籍管理ソフトウェア
calmly-writer	マークダウンフォーマットと選択したテーマを備えたワードプロセッサ
camed	XMLエディター
camera-live	ライブサイフォンカメラ
camerabag-photo	写真のフィルタリングと編集
camo-studio	画像調整コントロールを備えた高品質のウェブカメラとして携帯電話を使用する
camtasia	スクリーンレコーダーとビデオエディター
camunda-modeler	ワークフローおよび意思決定自動化プラットフォーム
candybar	ファイルアイコンを変更するツール
cantata	Qt5グラフィカルMPDクライアント
canva	デザインツール
caprine	エレガントなFacebookメッセンジャーデスクトップアプリ
captain	メニューバーからDockerコンテナを管理する
captin	CapsLockステータスを表示するツール
caption	字幕を自動的に検索して設定します
capto	スクリーンキャプチャ/レコーダーおよびビデオエディター
carbon-copy-cloner	ハードディスクのバックアップとクローン作成ユーティリティ
cardhop	連絡先マネージャー
caret	Caret
cashnotify	メニューバーからStripeアカウントとPaypalアカウントを監視します
castr	Castrストリーミングプラットフォームを制御するためのデスクトップアプリケーション
catch	ブロードキャッチが簡単に
catlight	開発者のためのアクションセンター
cave-story	古典的な8ビットおよび16ビットゲームを彷彿とさせるアクションアドベンチャーゲーム
ccleaner	ジャンクファイルと未使用ファイルを削除します
ccmenu	継続的インテグレーションサーバーを監視するためのアプリケーション
cctalk	リアルタイムのインタラクティブな教育プラットフォーム
cd-to	ターミナルで現在のディレクトリを開くためのFinderツールバーアプリ
celestia	宇宙を3次元で探索するための宇宙シミュレーション
celestialteapot-runway	UML（統一モデリング言語）デザインアプリ
cellprofiler	生物学的画像分析のためのオープンソースアプリケーション
cemu	CEmu
centered	生産性のためのフロー状態アプリ
cerebro	頭脳を備えたオープンソースの生産性ブースター
cernbox	CERNユーザー向けのクラウドストレージ
cevelop	C++ IDE
chai	システムがスリープ状態になるのを防ぐユーティリティ
chalk	電卓ソフトウェア
charles	Webデバッグプロキシアプリケーション
charlessoft-timetracker	TimeTracker
chatmate-for-facebook	Facebookメッセンジャークライアント
chatmate-for-whatsapp	WhatsAppのChatMate
chatology	チャットマネージャーとメッセージ検索ソフトウェア
chatterino	https://twitch.tvのチャットクライアント
chatty	Twitchチャットクライアント
chatwork	ChatWork
cheatsheet	現在のアプリケーションのすべてのアクティブなショートカットを一覧表示するツール
checkra1n	iPhone X、iOS12.0以降を介したiPhone5sの脱獄
cheetah3d	3Dモデリング、レンダリング、アニメーションソフトウェア
chef-workstation	Chefインフラストラクチャを管理するために必要なツールのオールインワンインストーラー
chemdoodle	2D化学描画、出版、情報学
chessx	チェスデータベース
chia	ChiaブロックチェーンのGUIPython実装
chiaki	PlayStationリモートプレイクライアント
chirp	アマチュア無線をプログラミングするためのツール
choosy	任意のブラウザでリンクを開く
chrome-devtools	Chrome DevTools
chrome-remote-desktop-host	GoogleChromeブラウザを介して別のコンピュータにリモートアクセスする
chromedriver	GoogleChrome用のWebアプリの自動テスト
chromium	無料のオープンソースWebブラウザ
chronicle	パーソナルファイナンスマネージャー
chronoagent	ChronoSyncのリモートファイル共有
chronos	JIRAおよびTrello用のデスクトップクライアント
chronosync	同期およびバックアップツール
chronycontrol	chronydをインストールして構成します
chrysalis	万華鏡を搭載したキーボード用のグラフィカルなコンフィギュレーター
cinc-workstation	Chefインフラストラクチャ管理ツール用のFree-as-in-Beerオールインワンインストーラー
cinch	ウィンドウ管理ツール
cinco	ドメイン固有のグラフィカルモデリングツール用のジェネレーター駆動型EclipseIDE
cinder	Cinder
cinderella	インタラクティブジオメトリソフトウェア
cinebench	Cinebench
circuitjs1	電子回路シミュレータ
cirrus	iCloudDriveフォルダーのインスペクター
cisco-jabber	CiscoのJabberクライアント
cisco-proximity	Cisco Proximity
cisdem-data-recovery	Cisdemデータリカバリ
cisdem-document-reader	Windowsベースのファイルを開いて表示するためのドキュメントリーダー
cisdem-pdf-converter-ocr	OCR機能を備えたPDFコンバーター
cisdem-pdfmanagerultimate	CisdemPDFManagerUltimate
citra	ニンテンドー3DSエミュレーター
citrix-workspace	マネージドデスクトップ仮想化ソリューション
cityofzion-neon	NEOブロックチェーン用ライトウォレット
ckan	Kerbal SpaceProgramのMod管理ソリューション
ckb-next	RGBドライバー
clamxav	ウイルス対策およびマルウェアスキャナー
clash-for-windows	Clashに基づくGUI
clashx	クラッシュに基づくGUIを備えたルールベースのカスタムプロキシ
classicftp	FTPファイル転送ソフトウェア
classroom-assistant	学生リポジトリを一括で複製するためのツール
classroom-mode-for-minecraft	Minecraft EducationEditionの教室管理アプリ
clay	人々をよりよく覚えるためのプライベートローロデックス
clean-me	ログ、キャッシュなどのシステムクリーナー
cleanapp	SyniumソフトウェアCleanApp
cleanmymac	ディスクから不要なファイルやフォルダを削除するツール
cleanmymac-zh	ディスク中国語版から不要なファイルやフォルダを削除するツール
cleanshot	画面キャプチャツール
cleartext	テキストエディタ
clementine	音楽プレーヤーと図書館の主催者
clickcharts	ClickCharts
clicker-for-netflix	最高のスタンドアロンNetflixプレーヤー
clicker-for-youtube	スタンドアロンのYouTubeアプリ
clickup	タスク、ドキュメント、目標、チャットのための生産性プラットフォーム
clion	CおよびC++ IDE
clip-studio-paint	描画とペイントのためのソフトウェア
clipgrab	Webサイトからビデオとオーディオをダウンロードします
clips-ide	エキスパートシステムを構築するためのツール
clipy	クリップボード拡張アプリ
clix	CLIX
cljstyle	Clojureコードをフォーマットするためのツール
clock	大きな時計
clock-bar	Macbook | 時計、タッチバーの右側
clock-signal	8ビットおよび16ビットプラットフォームのレイテンシーを嫌うエミュレーター
clocker	メニューバーのタイムゾーントラッカー
clockify	代理店やフリーランサーのためのタイムトラッキングツール
clocksaver	ブラウンの時計に触発されたスクリーンセーバー
clone-hero	ギターヒーロークローン
clonk	クローンレイジ
cloud-pbx	クラウドベースの電話システム
cloudapp	ビジュアルコミュニケーションプラットフォーム
cloudash	サーバーレスアーキテクチャの監視とトラブルシューティング
cloudcompare	CloudCompare
cloudflare-warp	インターネットをより安全にする無料アプリ
cloudmounter	クラウドストレージをローカルディスクとしてマウントします
cloudup	何でも瞬時に安全に共有
cloudytabs	iCloudタブを一覧表示するメニューバーアプリケーション
clover	1つのツールでメモ、ホワイトボード、ToDo、およびデイリープランナー
clover-configurator	CloverEFIブートローダー構成ヘルパー
cmake	ソフトウェアを構築、テスト、パッケージ化するためのツールファミリ
cmd-eikana	⌘英かな
cmdtap	TaskSwitcherに他の機能を追加します
cncjs	CNCフライス盤コントローラーのインターフェース
cncnet	CnCNet：クラシックコマンド＆コンカー
coarchi	Archi用のモデルコラボレーションプラグイン
coccinellida	シンプルなSSHトンネルマネージャー
coccoc	コック・コックブラウザ
cockatrice	マルチプレイヤーカードゲーム用の仮想卓上
cocktail	コンピュータシステムのクリーニング、修理、最適化
cocoapods	Cocoaプロジェクトの依存関係マネージャー
cocoarestclient	HTTP / RESTエンドポイントをテストするためのアプリ
cocoaspell	Aspellスペルチェッカーのサービスプロバイダー
coconutbattery	さまざまなデバイスのバッテリーに関するライブ情報を表示するツール
coconutid	MacまたはiPhoneの製造日を表示します
coda	テキストエディタ
code-composer-studio	統合開発環境
code-notes	Codeノート
code42-crashplan	エンドポイントのバックアップとリカバリ
codeexpander	クラウド同期開発ツール
codekit	ウェブサイトを構築するためのアプリ
codelite	C、C++、PHP、Node.js用のIDE
codeql	セマンティックコード分析エンジン
coderunner	多言語プログラミングエディタ
codespace	コードスニペットマネージャー
coffitivity-offline	アンビエントサウンドジェネレータ
cog	オーディオプレイヤー
coin-wallet	デジタル通貨ウォレット
coinomi-wallet	多くのブロックチェーン資産を安全に保管、管理、交換します
cold-turkey-blocker	Webサイト、ゲーム、およびアプリケーションをブロックする
color-oracle	カラーオラクル
colorchecker-camera-calibration	カスタムカメラプロファイルを構築するためのソフトウェア
colorpicker-developer	開発者カラーピッカー
colorpicker-materialdesign	マテリアルデザイン
colorpicker-propicker	プロピッカー
colorpicker-skalacolor	カラーピッカー
colorsnapper	カラーピッキングアプリケーション
colortester	ColorTester
colorwell	カラーピッカーとカラーパレットジェネレーター
colour-contrast-analyser	カラーコントラストチェッカー
combine-pdfs	PDFを組み合わせる
comictagger	ComicTagger
comma-chameleon	コンマカメレオン
command-pad	コマンドラインツールを開始および停止し、出力を監視します
command-tab-plus	キーボード中心のアプリケーションとウィンドウスイッチャー
commander-one	2パネルのファイルマネージャー
commandq	誤ってアプリを終了することはありません
composercat	Composer（PHP）のグラフィカルインターフェイス
compositor	WYSIWYGLaTeXエディター
conferences	会議のビデオを見るためのアプリ
confluent-cli	開発者がConfluentCloudまたはConfluentPlatformを管理できるようにします
connectiq	ConnectIQ SDKを使用して、Garminデバイスとセンサーのウェアラブルエクスペリエンスを構築します
connectmenow	ネットワーク共有をすばやく簡単にマウント
console	コンソール
container-ps	すべてのDocker画像を表示するアプリ
contexts	アプリケーションウィンドウを切り替えることができます
continuity-activation-tool	互換性のあるハードウェアで継続性機能を有効にする
contraste	コントラスト
controllermate	ControllerMate
controlplane	ControlPlane
convert3dgui	一般的なファイル形式間で3D画像を変換するためのコマンドラインツール
cookie	追跡およびオンラインプロファイリングからの保護
cool-retro-term	古いカソードディスプレイを模倣したターミナルエミュレータ
coolterm	シリアルポート端子
copyclip	クリップボードマネージャー
copyq	高度な機能を備えたクリップボードマネージャー
copytranslator	コピーしながらリアルタイムでテキストを翻訳するツール
coqide	正式な証明管理システム
cord	リモートデスクトップクライアント
core-data-editor	Core DataEditor
corelocationcli	コアロケーションCLI
cornercal	CornerCal
cornerstone	Subversionクライアント
corona-tracker	地図とチャートを備えたコロナウイルストラッカーアプリ
corretto	AmazonからのOpenJDKディストリビューション
coscreen	マルチユーザー画面共有を備えたコラボレーションツール
coteditor	Webページ、プログラムのソースコードなどのプレーンテキストエディタ
couchbase-server-community	分散型NoSQLクラウドデータベース
couchbase-server-enterprise	分散型NoSQLクラウドデータベース
couchpotato	NZBとTorrentを介した自動映画ダウンロード
couleurs	Couleurs
countdown	カウントダウンスクリーンセーバー
coverload	映画、音楽アルバムなどの高品質のアートワークをダウンロードする
cozy-drive	CosyCloudのファイル同期
cpuinfo	CPUメーターメニューバーアプリ
cr	XML/CSSベースの電子書籍リーダー
craftmanager	Craftツールを最新の状態に保つのに役立ちます
creality-slicer	すべてのCrealityFDM3Dプリンター用のスライサー
create-recovery-partition-installer	リカバリパーティションインストーラーの作成
createuserpkg	CreateUserPkg
creepy	Creepy
crescendo	リアルタイムイベントビューア
criptext	プライバシーを中心に構築されたメールサービス
cron	専門家やチームのためのカレンダー
cronnix	CronniX
crossover	Windowsソフトウェアを実行するためのツール
crosspack-avr	Atmel窶冱AVR ﾂ✓マイクロコントローラーの開発環境
crunch	非常識（非常に遅いが邪悪な良い）PNG画像の最適化
crushftp	ファイル転送サーバー
cryo	ビジュアルファイルマネージャー
crypter	暗号化ソフトウェア
cryptomator	マルチプラットフォームのクライアント側クラウドファイル暗号化ツール
cryptonomic-galleon	Tezosブロックチェーン用のソフトウェアウォレット
cryptr	HashicorpのVaultのGUI
crystalmaker	結晶および分子構造を視覚化する
crystax-ndk	GoogleのAndroidNDKのドロップイン代替品
cscreen	コマンドライン表示管理ユーティリティ
cubicsdr	クロスプラットフォームソフトウェア無線アプリケーション
cuda-z	CUDA対応のGPUとGPGPUに関する基本情報を表示する
cumulus	メニューバーにあるSoundCloudプレーヤー
cura-lulzbot	3D印刷ソリューション
curio	メモ取りと整理のアプリ
curiosity	SwiftUIRedditクライアント
curseforge	アドオンとMODをダウンロードして管理します
cursorcerer	カーソルセラー
cursorsense	カーソルの加速と感度を調整します
customshortcuts	メニュー項目のキーボードショートカットをカスタマイズする
cutesdr	復調およびスペクトル表示プログラム
cutter	Rizinを搭載したリバースエンジニアリングプラットフォーム
cyberduck	サーバーとクラウドストレージブラウザ
cyberghost-vpn	VPNクライアント
cycling74-max	独自のインタラクティブソフトウェアを作成するための柔軟なスペース
daedalus-mainnet	Cardanoブロックチェーン上のadaの暗号通貨ウォレット
daedalus-testnet	CardanoTestnetブロックチェーンのテストada用の暗号通貨ウォレット
daisydisk	ディスクスペースビジュアライザー
dangerzone	潜在的に危険なPDFまたはOfficeドキュメントを安全なPDFに変換する
darktable	写真ワークフローアプリケーションと生の開発者
darwindumper	ダーウィンダンパー
dash	APIドキュメントブラウザとコードスニペットマネージャー
dash-dash	Dash-暗号通貨の再発明
dashcam-viewer	ダッシュカムとアクションカムによって記録されたビデオ、GPSデータ、およびGフォースデータを表示する
dashlane	パスワードマネージャーとデジタルウォレットアプリケーション
dat	人間のために構築されたピアツーピアデータ共有アプリ
data-integration	エンドツーエンドのデータ統合および分析プラットフォーム
data-rescue	データ回復ソフトウェア
data-science-studio	大規模な機械学習のための迅速な実験と運用化
datadog-agent	システム、アプリ、サービス全体の監視とセキュリティ
datagraph	科学/統計グラフ作成ソフトウェア
datagrip	データベースとSQLIDE
datasette	Datasetteをラップするデスクトップアプリケーション
dataspell	プロのデータサイエンティストのためのIDE
datazenit	Datazenit
datovka	データメッセージにアクセスしてローカルデータベースに保存する
datweatherdoe	メニューバー天気アプリ
davmail	Exchangeサーバーで任意のメール/カレンダークライアントを使用する
day-o	Day-O
db-browser-for-sqlite	SQLiteデータベース用のブラウザ
dbeaver-community	ユニバーサルデータベースツールとSQLクライアント
dbeaver-enterprise	ユニバーサルデータベースツールとSQLクライアント
dbgate	MySQL、PostgreSQL、SQL Server、MongoDB、SQLiteなどのデータベースマネージャー
dbglass	Electronで構築されたPostgreSQLクライアント
dbkoda	dbKoda
dbngin	データベースバージョン管理ツール
dbschema	データベースの設計、文書化、および展開
dbvisualizer	データベース管理および分析ツール
dcommander	2ペインのファイルマネージャー
dcp-o-matic	ビデオ、オーディオ、字幕をDCP（Digital Cinema Democratized）に変換する
dcp-o-matic-batch-converter	ビデオ、オーディオ、字幕をDCP（Digital Cinema Democratized）に変換する
dcp-o-matic-encode-server	ビデオ、オーディオ、字幕をDCP（Digital Cinema Democratized）に変換する
dcp-o-matic-kdm-creator	ビデオ、オーディオ、字幕をDCP（Digital Cinema Democratized）に変換する
dcp-o-matic-player	デジタルシネマパッケージを再生する
dcv-viewer	NICEDCVリモートディスプレイプロトコルのクライアント
dd-utility	オペレーティングシステムのIMGおよびISOファイルの書き込みとバックアップ
ddnet	DDRaceのTeeworldsバージョン
deadbolt	Deadbolt
deathtodsstore	DeathToDSStore
debookee	ネットワークトラフィックアナライザ
deckset	Deckset
decloner	高速で信頼性の高い重複ファイルファインダー
deco	ReactNativeアプリケーションを構築するためのIDE
decrediton	信頼できる自律デジタル通貨のためのウォレットGUI
deeper	Finderや他のアプリの隠し機能を有効または無効にするツール
deepgit	ソースコードの履歴を調査するためのツール
deepl	テキストを理解して翻訳するようにAIをトレーニングします
deepnest	CNCマシンのネスティングアプリケーション
deepstream	データ同期リアルタイムサーバー
deezer	音楽プレーヤー
default-folder-x	アプリケーションの[開く]および[保存]ダイアログを拡張するユーティリティ
defold	デスクトップ、モバイル、ウェブゲームの開発のためのゲームエンジン
dejalu	DejaLu
delicious-library	おいしい図書館
deltachat	電子メールサーバーネットワーク経由でチャット
deltawalker	ファイルとフォルダを比較および同期するためのツール
deluge	BitTorrentクライアント
dendroscope	根付いた系統樹とネットワークのためのインタラクティブなビューア
denemo	楽譜作成プログラム
depthmapx	空間ネットワーク分析ソフトウェア
deskreen	Webブラウザを備えたデバイスをセカンダリ画面に変えます
desktoppr	デスクトップ画像を設定するためのコマンドラインツール
desktoputility	便利なシステムタスクへのクイックアクセス
desmume	ニンテンドーDSエミュレーター
detectx-swift	検索およびトラブルシューティングツール
detexify	Detexify
devbook	開発者向けの検索エンジン
devdocs	DevDocs.io用のフル機能のデスクトップアプリ
developerexcuses	開発者はスクリーンセーバーを言い訳します
deviceinfo	デバイス情報を表示する
devilutionx	最新のオペレーティングシステム用のDiabloビルド
devkinsta	KinstaによるローカルWordPress開発スイート
devolo-cockpit	構成およびネットワーク監視ソフトウェア
devonagent	Webをより効率的に検索するのに役立つツール
devonthink	ドキュメントの収集、整理、編集、注釈付け
devutils	開発者向けのオフラインツールボックス
dexed	DX7FMシンセサイザー
dhs	dylibハイジャックのスキャン
dia	構造図を描く
diagnostics	診断（クラッシュ）レポートビューア
dialpad	クラウド通信プラットフォーム
diashapes	Dia
dictater	Dictater
dictcc-en-de-dictionary-plugin	dict.cc英語-ドイツ語辞書プラグイン
dictionaries	辞書を開かずに単語を翻訳する
dictunifier	辞書変換ツール
difffork	DiffFork
diffmerge	ファイルを視覚的に比較してマージする
digikam	デジタルフォトマネージャー
digital	論理設計者および回路シミュレータ
dingtalk	アリババグループによるチームワークアプリ
dingtalk-lite	アリババグループによるチームワークアプリ
direqual	高度なディレクトリ比較ユーティリティ
discord	音声およびテキストチャットソフトウェア
discretescroll	一般的なスクロールホイールの問題を修正するユーティリティ
disk-arbitrator	ディスクアービトレーター
disk-diet	ディスクスペースを解放します
disk-drill	データ回復ソフトウェア
disk-expert	ディスクスペースアナライザ
disk-inventory-x	ディスク使用ユーティリティ
diskcatalogmaker	DiskCatalogMakerのトーストバンドルバージョン
diskmaker-x	システムインストールディスクを構築するためのツール
diskwave	どのファイルとフォルダが最も多くのディスクスペースを消費しているかを判断するためのユーティリティ
displaperture	ディスプレイの角を丸めます
displaycal	DisplayCAL
displays	モニターの解像度と設定マネージャー
ditto	スクリーンミラーリングとデジタルサイネージ
divvy	シンプルさに焦点を当てたアプリケーションウィンドウマネージャー
djl-bench	ユニバーサル機械学習モデルベンチマークツール
djv	DJVイメージング
djview	DjView
dmenu-mac	キーボードのみのアプリケーションランチャー
dmidiplayer	マルチプラットフォームMIDIファイルプレーヤー
dmm-player	DMM.comプラットフォーム用のビデオプレーヤー
dmm-player-for-chrome	ChromeでDMMの動画を再生する
do-not-disturb	オープンソースの物理アクセス（別名「邪悪なメイド」）攻撃検出器
docker	コンテナ化されたアプリケーションとマイクロサービスを構築して共有するためのアプリ
docker-toolbox	DockerToolbox
dockey	dockey
dockmate	ウィンドウのプレビューとコントロール
dockstation	ドックステーション
dockview	ドックでアプリケーションウィンドウをプレビューするユーティリティ
dogecoin	暗号通貨
dolphin	ゲームキューブとWiiのゲームをプレイするエミュレーター
doomsday-engine	Doom、Heretic、Hexenの拡張ソースポート
dosbox	DOSを使用したx86用エミュレーター
dosbox-x	DOSBoxプロジェクトのフォーク
doteditor	DotEditor
dotnet	開発者プラットフォーム
dotnet-sdk	開発者プラットフォーム
double-commander	ファイルマネージャー
doubletwist	doubleTwist
doughnut	ポッドキャストクライアント
downie	さまざまなWebサイトからビデオをダウンロードします
doxie	スキャナーハードウェア用のコンパニオンアプリ
doxygen	ソースコードからドキュメントを生成する
dozer	ステータスバーアイコンを非表示にするツール
drawbot	2次元グラフィックスを生成するPythonスクリプトを作成する
drawio	Draw.ioは無料のオンラインダイアグラムソフトウェアです
dremel-slicer	CADファイルを安全にスライスする
drivedx	健康診断および監視ツールを駆動する
drivethrurpg	DriveThruRPGライブラリを互換性のあるデバイスに同期する
droidid	DroidID
drop-to-gif	アニメーションGIFをゼロクリック
dropbox	Dropboxクラウドストレージサービスのクライアント
dropbox-capture	あなたの仕事やアイデアをビデオメッセージやスクリーンショットで共有しましょう
dropbox-passwords	デバイス間で同期するパスワードマネージャー
dropdmg	DMGおよびその他のアーカイブを作成する
dropletmanager	デジタルオーシャンドロップレットマネージャー
droplr	スクリーンショットとスクリーンレコーダー
dropshare	ファイル共有ソリューション
dropzone	生産性アプリ
drovio	リモートペアプログラミングおよびチームコラボレーションツール
dteoh-devdocs	APIドキュメントビューア
duckietv	セミオートマジックトレント統合でテレビ番組を追跡するためのツール
duefocus	時間追跡および生産性ソフトウェア
duet	iPadをセカンドディスプレイとして使用するためのツール
dungeon-crawl-stone-soup-console	ダンジョン探検、戦闘、魔法のゲーム
dungeon-crawl-stone-soup-tiles	ダンジョン探検、戦闘、魔法のゲーム
duo-connect	組織にアクセスする窶冱SSHサーバー
dupeguru	コンピュータシステムで重複ファイルを検索します
duplicacy	クラウドバックアップツール
duplicacy-web-edition	クラウドバックアップツール
duplicate-annihilator-for-photos	写真の複製アニヒレーター
duplicate-file-finder	不要な重複ファイルやフォルダを見つけて削除する
duplicati	安全に暗号化されたバックアップをクラウドに保存する
dupscanub	指定されたフォルダ内の重複ファイルを検索します
dust3d	Dust3D
dusty	Dusty
dvdstyler	DVDオーサリングアプリケーション
dwarf-fortress	シングルプレイヤーファンタジーゲーム
dwarf-fortress-lmp	ゲームを壊すことなく、DwarfFortressでグラフィックパックを使用および切り替えます
dwgsee	DWGSee
dwihn0r-keepassx	KeePassX
dyalog	APLベースの開発環境
dyn-updater	Dynアップデータ
dynalist	ダイナリスト
dynamic-dark-mode	自動ダークモードトグル
dynamodb-local	AmazonDynamoDBローカル
dynobase	DynamoDB用のGUIクライアント
eagle	Autodesk EAGLE
eaglefiler	ファイルの整理、電子メールのアーカイブ、Webページとメモの保存、すべての検索
ealeksandrov-cd-to	ターミナルで現在のディレクトリを開くためのFinderツールバーアプリ
ears	インスタントオーディオスイッチャー
easy-move-plus-resize	修飾キーとマウスドラッグを使用した移動とサイズ変更をサポートするユーティリティ
easyeda	PCB設計ツール
easyfind	任意のファイル内のファイル、フォルダー、またはコンテンツを検索します
easytether	キャリアに依存しないインターネット接続の共有（テザリング）
ebibookreader	ebi.BookReader
ebmac	電子辞書ビューア
eclipse-cpp	CおよびC ++開発者向けのEclipseIDE
eclipse-dsl	JavaおよびDSL開発者向けのEclipseIDE
eclipse-ide	Eclipse統合開発環境
eclipse-installer	Eclipse開発環境をインストールして更新します
eclipse-java	Java開発者向けのEclipseIDE
eclipse-javascript	JavaScriptおよびWeb開発者向けのEclipseIDE
eclipse-jee	JavaEE開発者向けのEclipseIDE
eclipse-modeling	モデルベースのアプリケーションを構築するためのツールとランタイム
eclipse-php	PHP開発者向けのEclipseIDE
eclipse-platform	EclipseIDE用のSDK
eclipse-rcp	RCPおよびRAP開発者向けのEclipseIDE
eclipse-testing	テスト用のEclipseIDE
eddie	OpenVPN UI
edenmath	EdenMath
edex-ui	サイエンスフィクションをテーマにしたターミナルエミュレーターとシステムモニター
edfbrowser	EDF+およびBDF+ビューアとツールボックス
editaro	テキストエディタ
eggplant	eggPlant機能
eiskaltdcpp	ダイレクトコネクトおよびADCプロトコルを使用したファイル共有
ejector	メニューバーにイジェクトアイコンを追加します
elan	オーディオおよびビデオ録画用の注釈ツール
elasticwolf	アマゾンウェブサービス（AWS）クラウドリソースを管理する
electerm	ターミナル/ ssh /シリアルポート/ sftpクライアント
electorrent	デスクトップリモートトレントアプリケーション
electric-sheep	コラボレーティブ抽象アートワークソフトウェア
electricbinary	集積回路の設計のための電気CADシステム
electrocrud	データベースCRUDアプリケーション
electron	JavaScript、HTML、CSSを使用してデスクトップアプリを構築する
electron-api-demos	ElectronAPIを探索する
electron-cash	ビットコインキャッシュ用のシンクライアント
electron-fiddle	小さな電子実験を作成して遊ぶ
electronic-wechat	電子WeChat
electronmail	非公式のProtonMailデスクトップアプリ
electrum	ビットコインシンクライアント
electrum-ltc	ライトコインウォレット
electrumsv	ビットコインSV用のデスクトップウォレット
element	マトリックスコラボレーションクライアント
elmedia-player	ビデオおよびオーディオプレーヤー
eloston-chromium	Google Chromium、Googleとの統合なし
elpass	パスワードマネージャー
emacs	テキストエディタ
emacsclient	emacsでのorg-captureを容易にするChrome / Firefox拡張機能
emailchemy	電子メールの移行、変換、およびアーカイブソフトウェア
emby-server	ほぼすべてのデバイスにアプリを搭載したパーソナルメディアサーバー
emclient	メールクライアント
eme	マークダウンエディタ
emmetapp	ウィンドウマネージャーとウィンドウサイズ変更ツールのタイリングとスタッキング
emojipedia	絵文字pedia
empoche	タスクおよびプロジェクト管理による自動タイムトラッキング
enclave	構成、ファイアウォール、アクセス制御リストを使用せずにプライベートネットワークを安全に構築する
encryptme	VPNおよび暗号化ソフトウェア
encryptr	ゼロ知識クラウドベースのパスワードマネージャー
endless-sky	宇宙探査、取引、戦闘ゲーム
endnote	リファレンスマネージャー
endurance	バッテリーの監視と管理
energia	エレクトロニクスプロトタイピングプラットフォーム
energybar	EnergyBar
enfusegui	HDRイメージクリエーター
engine-prime	デノンのエンジンOSハードウェア用の音楽管理ソフトウェア
enigma	OxydとRock'n'Rollに触発されたパズルゲーム
enjoyable	Enjoyable
enpass	パスワードとクレデンシャルの管理
entropy	ファイルアーカイバ
envkey	クレデンシャルを保護し、構成を同期します
enzymex	EnzymeX
epic	プライベートで安全なWebブラウザ
epic-games	*Epic Games *ゲームのランチャー
epichrome	スタンドアロンアプリのように機能するWebベースのアプリケーションを作成するためのツール
epilogue-operator	コンピューターでゲームボーイカートリッジを再生および管理する
epoccam	お使いの携帯電話をウェブカメラに変える
epoch-flip-clock	エポックフリップクロックスクリーンセーバー
epub-to-pdf	epub-2-pdf
epubmdimporter	EPUBスポットライト
epubquicklook	QuickLookジェネレーターとSpotlightインポーター
eqmac	システム全体のオーディオイコライザー
equinox	ダイナミックな壁紙を作成する
eset-cyber-security-pro	ESET Cyber​​ Security Pro
espresso	才能と効率に焦点を当てたウェブサイトエディター
ethereum-wallet	イーサリアムネットワーク上のﾃタイミングのブラウザ
etrecheckpro	コンピュータシステムの問題を見つけて修正するためのユーティリティ
eudic	ヨーロッパの辞書
eul	ステータスモニタリング
eurkey	ヨーロッパ人、コーダー、翻訳者向けのキーボードレイアウト
ev3-classroom	レゴマインドストームエデュケーションEV3コアセット用コンパニオンアプリ
eve-launcher	EVEOnlineクライアント
evernote	メモを取る、整理する、タスクリスト、アーカイブするためのアプリ
evkey	ベトナム語キーボード
exactscan	Doceumentスキャナー
exfalso	音楽タグエディタ
exifcleaner	メタデータクリーナー
exifrenamer	デジタル写真、ムービー、オーディオクリップの名前を変更するツール
exist-db	ネイティブXMLデータベースとアプリケーションプラットフォーム
exodus	暗号通貨資産用のデスクトップウォレット
expandrive	クラウドストレージ用のネットワークドライブとブラウザ
explorer	データエクスプローラー
expo-xde	Expo開発環境（XDE）
expressions	正規表現マネージャーアプリ
expressscribe	ExpressScribeトランスクリプションソフトウェア
expressvpn	安全なインターネットアクセスとプライベートブラウジングのためのVPNクライアント
extraterm	ターミナルエミュレータのスイスアーミーチェーンソー
f-bar	メニューバーからLaravelForgeサーバーを管理する
fabfilter-micro	フィルタープラグイン
fabfilter-one	シンセサイザープラグイン
fabfilter-pro-c	コンプレッサープラグイン
fabfilter-pro-ds	ディエッサープラグイン
fabfilter-pro-g	ゲート/エキスパンダープラグイン
fabfilter-pro-l	リミッタープラグイン
fabfilter-pro-mb	マルチバンドコンプレッサープラグイン
fabfilter-pro-q	イコライザープラグイン
fabfilter-pro-r	リバーブプラグイン
fabfilter-saturn	マルチバンドディストーション/サチュレーションプラグイン
fabfilter-simplon	フィルタープラグイン
fabfilter-timeless	テープ遅延プラグイン
fabfilter-twin	シンセサイザープラグイン
fabfilter-volcano	フィルタープラグイン
factor	プログラミング言語
fake	Web自動化とテスト用のブラウザ
falcon-sql-client	無料のオープンソースSQLクライアント
fanny	FannyWidget
fantastical	予定表ソフトウェア
fantasy-grounds	ファンタジーグラウンド
fantasy-map-generator	インタラクティブで高度にカスタマイズ可能なマップを生成する
far2l	FAR Managerv2のUnixフォーク
farrago	オーディオ再生
fastclicker	自動クリッカーとマウス自動化ユーティリティ
fastmarks	Webブラウザのブックマークを検索して開きます
fastrawviewer	RAWファイルを開き、オンザフライでレンダリングします
fastscripts	時間を節約するスクリプトを実行するためのツール
fauxpas	Faux Pas
favro	コラボレーティブプランニングアプリ
fawkes	顔認識を回避するために画像ファイルをマントします
faxbot	FRITZ！Box経由でFAXを送信
fbreader	FBReader
fedora-media-writer	Fedoraイメージをポータブルメディアファイルに書き込むためのツール
feed-the-beast	Minecraftmodダウンローダーおよびマネージャー
feem	ローカルファイル転送
feishu	プロジェクト管理ソフトウェア
fellow	共同会議の議事議、メモ、およびアクションアイテム
fenix	コラボレーション機能を備えたシンプルで視覚的な静的Webサーバー
ferdi	複数のサービスを組み合わせたメッセージングブラウザ
fetch	ファイル転送クライアント
ff-works	ビデオエンコーディングおよびトランスコーディングアプリ
fig	ターミナルを再考する
figma	コラボレーティブチームソフトウェア
figmadaemon	Figmaフォントインストーラー
figtree	FigTree
fiji	オープンソースの画像処理パッケージ
file-juicer	PDF、PowerPoint、Word、Excelおよびその他のファイルから画像を抽出します
filebot	映画、テレビ番組、アニメ、音楽を整理して名前を変更するためのツール
filemaker-pro	リレーショナルデータベースと迅速なアプリケーション開発プラットフォーム
filemon	ファイルモニター
filepane	ファイル管理マルチツール
final-cut-library-manager	FCPXライブラリマネージャー
final-fantasy-xiv-online	ストーリー主導の大規模マルチプレイヤーオンラインロールプレイングゲーム
finalshell	SSHツール、サーバー管理、およびリモートデスクトップアクセラレーションソフトウェア
find-any-file	ファイルファインダー
find-empty-folders	空のフォルダを検索します
findergo	Finderからターミナルをすばやく開く
finereader	ドキュメントから情報を解析するためのツール
fing	ネットワークスキャナー
fing-cli	ネットワークスキャナー
finicky	起動するブラウザをカスタマイズするためのユーティリティ
finisher-voodoo	VST / AU / AAXギターエフェクトプラグイン
firealpaca	Fire Alpaca
firebase-admin	Firebase管理者
firebird-emu	firebird
firecamp	マルチプロトコルAPI開発プラットフォーム
firefly	IOTAの公式ウォレット
firefox	ウェブブラウザ
firestorm	仮想世界にアクセスするためのビューア
firestormos	仮想世界にアクセスするためのビューア
fireworks	パーティクルエフェクトエディタ
firmaec	デジタル証明書を介してドキュメントに署名する
fiscript	FiScript
fishing-funds	メニューバーに中国のファンドのリアルタイムトレンドを表示する
fission	オーディオエディタ
fitbit-os-simulator	Fitbit用のアプリと文字盤を作成する
fl-studio	デジタルオーディオ制作アプリケーション
flacon	オープンソースオーディオファイルエンコーダ
flame	iPhone / iPodtouch用のランデブーサービスブラウザ
flameshot	スクリーンショットソフトウェア
flash-decompiler-trillix	Flash Decompiler Trillix
fldigi	アマチュア無線デジタルモデムアプリケーション
flexiglass	Flexiglass
flic	FlicBluetoothボタンのドライバー
flickr-uploadr	Flickrアップローダー
flightgear	フライトシミュレータ
flip4mac	再生してWindowsメディアを変換する
flipper	モバイル開発者向けのデスクトップデバッグプラットフォーム
fliqlo	パタパタ時計のスクリーンセーバー
flirc	Flirc
flixtools	映画の字幕をダウンロードする
flock	ビジネスメッセージングおよびチームコラボレーションアプリ
flomo	メモ取りと管理アプリ
flotato	任意のWebページをデスクトップアプリに変えるツール
flow	Flow
flowdock	Flowdock
flowsync	PolarFlow製品用の同期ソフトウェア
flrig	アマチュア無線リグ制御
fluent-reader	RSS / Atomニュースアグリゲーター
fluid	ウェブサイトをデスクトップアプリに変えるツール
flume	Instagramデスクトップクライアント
fluor	アクティブなアプリケーションに応じて、fnキーの動作を変更します
flutter	モバイル、ウェブ、デスクトップ向けのアプリケーションを構築するためのUIツールキット
flux	画面の色温度コントローラー
flvcd-bigrats	大きなネズミMAC
fly	ConcourseCIの公式CLIツール
flycut	開発者向けクリップボードマネージャー
flying-carpet	アドホックwifiを介したファイル転送
fmail	Fastmailの非公式ネイティブアプリケーション
fman	fman
fme	空間データを統合するためのプラットフォーム
focus	ウェブサイトとアプリケーションブロッカー
focus-booster	タイムトラッカー
focusatwill	パーソナライズされたフォーカスミュージック
focused	マークダウンライティングアプリ
focuswriter	気を散らすことのないライティング環境
fog	非公式のovercast.fmポッドキャストアプリ
folder-colorizer	フォルダーアイコンエディター＆マネージャー
folding-at-home	折りたたみ用のグラフィカルインターフェイス制御
foldingtext	FoldingText
foldit	Foldit
folx	トレントクライアントでマネージャーをダウンロード
font-smoothing-adjuster	フォントスムージングコントロールを再度有効にする 
fontbase	フォントマネージャー
fontexplorer-x-pro	フォントファインダーおよびオーガナイザー
fontforge	アウトラインおよびビットマップフォント用のフォントエディタおよびコンバータ
fontgoggles	さまざまなフォント形式のフォントビューア
fontlab	プロフェッショナルフォントエディタ
fontplop	オープンソースのウェブフォントコンバーター
fontstand	フォントの発見とレンタルのプラットフォーム
foobar2000	オーディオプレイヤー
force-paste	強制貼り付け
forecast	チャプター付きポッドキャストMP3エンコーダー
fork	GITクライアント
forklift	Finderの置き換えとFTP、SFTP、WebDAV、Amazons3クライアント
forticlient	エンドポイント保護とクラウドサンドボックスを備えたファブリックエージェント
forticlient-vpn	FortiClient用の無料VPNクライアント
fotokasten	写真製品を作成して購入する
foxglove-studio	ロボット工学のための視覚化およびデバッグツール
foxit-pdf-editor	PDFエディター
foxitreader	PDFリーダー
foxmail	メールクライアント
fpc-laz	Lazarus用のPascalコンパイラ
fpc-src-laz	Lazarus用のPascalコンパイラソースファイル
framer	チームが製品エクスペリエンスのあらゆる部分を設計するのに役立つツール
framer-x	チームが製品エクスペリエンスのあらゆる部分を設計するのに役立つツール
franz	WhatsApp、Facebook Messenger、Slack、Telegramなどのメッセージングアプリ
freac	オーディオコンバーターとCDリッパー
fredm-fuse	UNIX ZXSpectrumエミュレーターFuseのポート
free-download-manager	アクセラレータとオーガナイザーをダウンロードする
free-ruler	水平および垂直定規
free42-binary	HP-42S計算機シミュレーター
free42-decimal	HP-42S計算機シミュレーター
freecad	3Dパラメトリックモデラー
freecol	ターン制ストラテジーゲーム
freedom	アプリとウェブサイトのブロッカー
freedome	VPNクライアント
freemind	Javaで書かれたマインドマッピングソフトウェア
freenettray	Freenetを制御するためのメニューバーアプリケーション
freeorion	ターン制の宇宙帝国と銀河の征服ゲーム
freeplane	マインドマッピングおよび知識管理ソフトウェア
freesmug-chromium	Chromeの非互換性の問題を解決するために構築されたGoogleChromium
freesurfer	脳のMRI画像を処理および分析するためのオープンソースソフトウェアスイート
freetube	プライバシーに焦点を当てたYouTubeプレーヤー
freeyourmusic	プレイリスト、トラック、アルバムを音楽プラットフォーム間で移動する
freeze	AmazonGlacierファイル転送クライアント
frescobaldi	LilyPondエディター
frhelper	フランス語-中国語辞書および学習ツール
fromscratch	スクラッチパッドの自動保存。シンプルだがスマートなメモ取りアプリ
front	顧客コミュニケーションプラットフォーム
fs-uae	Amigaエミュレーター
fs-uae-launcher	Amigaエミュレータランチャー
fsmonitor	FSMonitor
fsnotes	ノートマネージャー
fspy	静止画カメラマッチング
fstream	FStream
fugu	Fugu
functionflip	ファンクションキーコントロール
funter	隠しファイルと隠しフォルダを表示し、Finderでそれらの表示を切り替えます
fuse	Fuseフレームワークを操作するためのビジュアルデスクトップツールスイート
futubull	トレーディングアプリケーション
futurerestore-gui	FutureRestoreのグラフィカルインターフェイス
fuwari	粘着性のあるフローティングスクリーンショット
fuzzyclock	FuzzyClock
fvim	NeovimテキストエディタのGUI
fxfactory	巨大なカタログからエフェクトとプラグインを閲覧、インストール、購入する
g-desktop-suite	Gデスクトップスイート
gactions	Google ActionsSDK用のCLIツール
gameranger	GameRanger
ganache	イーサリアム開発のためのパーソナルブロックチェーン
ganttproject	ガントチャートとプロジェクト管理アプリケーション
gaphor	UML / SysMLモデリングツール
garagebuy	eBayでのアイテムの検索、追跡、購入を支援するアプリ
garagesale	eBayリストを管理する
gargoyle	インタラクティブフィクションプレーヤーのIOレイヤー
gas-mask	ホストファイルエディター/マネージャー
gather	仮想ビデオ通話スペース
gb-studio	レトロゲームクリエイターをドラッグアンドドロップします
gcc-arm-embedded	32ビットArmプロセッサ用の構築済みGNUベアメタルツールチェーン
gcollazo-mongodb	MongoDBのアプリラッパー
gcs	GURPS第4版ロールプレイングゲームのキャラクターシートエディター
gdat	常染色体DNAを利用して家系図の研究を支援するアプリ
gdisk	ディスクパーティションツール
gdlauncher	カスタムMinecraftランチャー
geany	高速で軽量なIDE
gearboy	ギアボーイ
gearsystem	ギアシステム
geburtstagschecker	GeburtstagsChecker
geekbench	コンピュータシステムのパフォーマンスを測定するためのツール
geektool	デスクトップカスタマイズツール
gemini	重複した類似のファイルを見つけて削除するディスクスペースクリーナー
geneious-prime	バイオインフォマティクスソフトウェアプラットフォーム
genymotion	Androidエミュレータ
geogebra	数学の問題、グラフ関数などを解決、保存、共有します
geomap	地球科学データセットの閲覧、視覚化、分析
geotag	画像のジオロケーションエディタ
geotag-photos-pro	ジオタグソフトウェア
geph	モジュラーインターネット検閲回避システム
gephi	GraphVizグラフを視覚化して探索するためのユーティリティ
get-backup-pro	フォルダ同期を備えたバックアップソフトウェア
get-iplayer-automator	BBCとITVの番組をダウンロードして視聴する
get-lyrical	iTunesの曲に歌詞を自動的に追加する
gfxcardstatus	gfxCardStatus
ghdl	VHDL2008/93/87シミュレータ
ghidra	ツールのソフトウェアリバースエンジニアリング（SRE）スイート
ghost-browser	ウェブブラウザ
ghosttile	実行中のアプリケーションをDockから非表示にする
gifcapture	GifCapture
gifox	画面を記録するアプリ
gifrocket	ビデオからGIFを作成するためのツール
gimp	無料のオープンソース画像エディタ
gingko	構造と内容を表示するワードプロセッサ
gisto	（チーム）共有オプションを備えたスニペット管理デスクトップアプリケーション
git-it	GitとGitHubを学習するためのデスクトップアプリ
gitahead	GitAhead
gitblade	Gitのグラフィカルクライアント
gitdock	すべてのGitLabアクティビティを1か所に表示します
gitee	GitHubのステータスバーアプリケーション
giteye	Gitクライアント
gitfiend	Gitクライアント
gitfinder	Finderと統合されたGitクライアント
gitfox	Gitクライアント
github	GitHubリポジトリ用のデスクトップクライアント
githubpulse	GithubPulse
gitify	デスクトップにGitHub通知を表示するアプリ
gitkraken	生産性に焦点を当てたGitクライアント
gitnote	gitnote
gitpigeon	GitPigeon
gitscout	Gitscout
gitter	ギッター
gitup	視覚的な相互作用に焦点を当てたGitインターフェース
gitx	GitX
glance	ネイティブでサポートされていないファイルのクイックルックプレビューを提供するユーティリティ
glimmerblocker	GlimmerBlocker
gloomhaven-helper	Gloomhavenボードゲームをプレイするための公式にライセンスされたコンパニオンアプリケーション
gltfquicklook	glTFファイル用のQuickLookプラグイン
gluemotion	タイムラプス動画を作成して修正する
glyphfinder	デザイナー、開発者、作家のためのキャラクター検索
glyphs	フォントエディタ
gmail-notifier	ミニマリストのGmail受信トレイ通知アプリ
gmvault	Gmvault
gns3	DynamipsCiscoルーターエミュレーターのGUI
gnucash	複式簿記プログラム
go-agent	Go継続的デリバリープラットフォームのエージェント
go-server	Go継続的デリバリープラットフォーム用のサーバー
go2shell	Go2Shell
go64	32ビットアプリケーションのコンピューターディスクをスキャンする
gobdokumente	文書管理システム
godot	ゲーム開発エンジン
godot-mono	2Dおよび3Dゲームエンジン
gog-galaxy	ゲームクライアント
gogs	セルフホストのGitサービス
goland	Go（golang）IDE
goldencheetah	サイクリスト、ランナー、トライアスリート向けのパフォーマンスソフトウェア
goldendict	GoldenDict
goldenpassport	Swift3に基づくGoogle認証システムのネイティブ実装
golly	コンウェイのライフゲームやその他の種類のセルオートマトンを探索する
goneovim	Golangqtバックエンドを使用してGolangで記述されたNeovimGUI
goodsync	ファイル同期およびバックアップソフトウェア
goofy	FacebookMes​​senger用のデスクトップクライアント
google-ads-editor	Google広告エディター
google-analytics-opt-out	ウェブサイトの訪問者のデータがGoogleAnalyticsJavaScriptによって使用されないようにする
google-assistant	デスクトップ用のクロスプラットフォームの非公式Googleアシスタントクライアント
google-chat	チャット
google-chat-electron	Googleチャット用のスタンドアロンアプリ
google-chrome	ウェブブラウザ
google-cloud-sdk	GoogleCloudでホストされているリソースとアプリケーションを管理するためのツールのセット
google-drive	Googleドライブストレージサービスのクライアント
google-drive-file-stream	Googleドライブストレージサービスのクライアント
google-earth-pro	仮想地球
google-featured-photos	スクリーンセーバー写真プロバイダー
google-japanese-ime	Google日本語入力方式エディター
google-trends	Googleトレンドのスクリーンセーバー
google-web-designer	インタラクティブなHTML5ベースのデザインとモーショングラフィックスを作成する
googleappengine	クラウドコンピューティングプラットフォーム
gopanda	パンダネットクライアント
gopass-ui	チームのパスワードマネージャー
gosign	デジタル署名とタイムスタンプアプリ
gotiengviet	GoTiengViet
gotomeeting	オンライン会議、デスクトップ共有、およびビデオ会議
gpg-suite	メールやファイルを保護するためのツール
gpg-suite-no-mail	ファイルを保護するためのツール
gpg-suite-pinentry	GPGSuite用のPinentryGUI
gpg-sync	GPG同期
gplates	プレートテクトニクスプログラム
gpodder	ポッドキャストクライアント
gpower	統計的検出力分析を計算するためのツール
gps4cam	写真にジオタグを付ける
gpxsee	GPSログファイルビューアおよびアナライザ
gqrx	GNURadioとQtを搭載したソフトウェア無線受信機
grads	地球科学データへのアクセス、操作、視覚化
grafx	256色の塗装プログラム
grammarly	テキストの文法エラーとスタイルの問題を修正するユーティリティ
grammarly-desktop	デスクトップ用の文法
gramps	系図ソフトウェア
grandperspective	ファイルシステム内のディスク使用量をグラフィカルに表示
grandtotal	請求書と見積もりを作成する
graphicconverter	画像の閲覧、強調、変換に
graphiql	GraphiQLの周りの軽量の電子ベースのラッパー
graphql-ide	GraphQLAPIを探索するためのIDE
graphql-playground	より良い開発ワークフローのためのGraphQLIDE
graphsketcher	グラフ描画とデータプロットアプリ
gray	アプリごとに明るいまたは暗い外観を設定するツール
greenfoot	Javaでオブジェクト指向を教える
gretl	計量経済分析用のソフトウェアパッケージ
grid	ウィンドウマネージャー
grid-clock	グリッドクロックスクリーンセーバー
gridea	静的なブログ執筆クライアント
grids	Instagramデスクトップアプリケーション
gridtracker	使いやすいインターフェースで表示されるアマチュア無線情報の倉庫
grisbi	個人財務管理プログラム
growlnotify	通知システム
gswitch	使用するグラフィックカードを設定する
gtkwave	GTK +ベースのウェーブビューア
guijs	JSプロジェクトを管理するためのグラフィカルインターフェイス
guild-wars2	ギルドウォーズ2
guilded	グループチャットプラットフォーム
guitar-pro	ギター、ベース、キーボード、ドラムなどの楽譜エディタソフトウェア
gulp	gulp-app
guppy	React.jsのフレンドリーなアプリケーションマネージャーとタスクランナー
gureumkim	クラウド入力 
gyazmail	メールクライアント
gyazo	スクリーンショットと画面記録ツール
gzdoom	OpenGLレンダラーをZDoomソースポートに追加します
ha-menu	一般的なHomeAssistant機能を実行するためのメニューバーアプリ
hacker-menu	デスクトップに配信されるハッカーニュース：ダンサー：
hackintool	Hackintoshパッチツール
hackmd	HackMD
hackolade	RDBMSでのNoSQLデータベース、ストレージ形式、REST API、JSONのデータモデリング
hakuneko	白猫
hammerspoon	デスクトップ自動化アプリケーション
hancock	ハンコック
hancom-word	ワードプロセッサ
handbrake	オープンソースのビデオトランスコーダー
handbrakebatch	HandBrakeBatch
handshaker	Androidデバイスを管理するためのアプリ
handyprintpro	AirPrintサーバー
happygrep	happygrep
happymac	システムの速度を低下させるバックグラウンドプロセスを監視、一時停止、再開します
haptic-touch-bar	触覚タッチバー
haptickey	タッチバーをタップすると触覚フィードバックをトリガーします
harbor	ステータスバーからCodeshipビルドを監視するツール
harmony	音楽プレーヤー
haroopad	Haroopad
hashbackup	コマンドラインバックアッププログラム
hazel	自動化された組織
hazeover	Windowsマネージャーとデスクトップオーガナイザー
hbuilderx	HTMLエディター
hdrmerge	拡張されたダイナミックレンジで生の画像を作成します
headset	YouTubeとRedditを搭載した音楽プレーヤー
heaven	PCハードウェアのパフォーマンスと安定性のテスト
hedgewars	ターン制ストラテジー、砲兵、アクション、コメディーゲーム
heimdall-suite	Samsungモバイルデバイスへのフラッシュファームウェア
helium	Helium
helo	メールテスターとデバッガー
hermes	Hermes
hermit-crab	現在のアプリを離れずにシェルコマンドを実行する
hex-fiend	速度に焦点を当てた16進エディタ
hey	HEYメールサービスにアクセスする
hfsleuth	HFSleuth
hiarcs-chess-explorer	チェスデータベース、分析およびゲームプレイプログラム
hiddenbar	メニューバー項目を非表示にするユーティリティ
hightop	メニューバーを介したファイルアクセス
historyhound	ブラウザの履歴とブックマークのキーワード検索
hma-pro-vpn	HideMyAss！プロVPN
holavpn	ピアツーピアVPN
home-assistant	HomeAssistantホームオートメーションソフトウェアのコンパニオンアプリ
home-inventory	家や持ち物のドキュメンテーションアプリケーション
honer	フォーカスされたウィンドウの周囲に境界線を描画するユーティリティ
honto	本堂店の電子書籍リーダー
hook	重要な情報をリンクして取得する
hookshot	ウィンドウスナップツール
hopper-debugger-server	ホッパーデバッガサーバー
horndis	AndroidUSBテザリングドライバー
horos	医用画像ビューア
hostsx	ローカルホスト更新ツール
hot	熱の問題によるCPU速度制限を表示するメニューバーアプリケーション
hotswitch	2ストロークホットキーを使用した高速ウィンドウスイッチャー
houdahspot	ファイル検索アプリケーション
houseparty	対面のソーシャルネットワーキングアプリ
hp-eprint	モバイル印刷ソリューション
hp-prime	グラフ電卓エミュレータ
hstracker	ハースストーンのデッキトラッカーおよびデッキマネージャー
http-toolkit	HTTP（S）デバッグプロキシ、アナライザー、およびクライアント
hubstaff	作業時間トラッカー
hue-topia	PhilipsHue電球の手動制御
hugin	パノラマ写真スティッチャー
hush	SafariでCookieとプライバシーを侵害する追跡を受け入れるためにnagsをブロックする
hwsensors	利用可能なハードウェアセンサーからの情報にアクセスするためのツール
hydrogen	ドラムマシンとシーケンサー
hydrus-network	メディアを整理するためのパーソナルブールスタイルのメディアタガー
hype	アニメーション化されたインタラクティブなWebコンテンツを作成するアプリ
hyper	Webテクノロジーに基づいて構築されたターミナル
hyperbackupexplorer	SynologyNASからのバックアップデータ
hyperdock	HyperDock
hyperkey	CapsLockキーまたは修飾キーのいずれかをハイパーキーに変換します
hyperswitch	HyperSwitch
i1profiler	写真家やデザイナーのための自動化とクリエイティブなコントロール
ibabel	iBabel
ibackup	バックアップユーティリティ
ibackup-viewer	iPhoneバックアップからデータを抽出する
ibackupbot	iBackupBot
ibettercharge	バッテリーレベル監視ソフトウェア
ibm-aspera-connect	Aspera転送サーバーを使用してアップロードとダウンロードを容易にします
ibm-cloud-cli	コマンドラインAPIクライアント
ibored	16進エディタ
icab	代替Webブラウザ
icanhazshortcut	ショートカットマネージャー
icc	チェスクラブのクライアント
iceberg	Iceberg
icefloor	ファイアウォールツール
icestudio	オープンFPGAボード用のビジュアルエディタ
icloud-control	iCloudドライブのユーザー制御の選択的同期
icollections	デスクトップを整理するのに役立つアプリ
iconizer	Iconizer
iconjar	アイコンオーガナイザー
icons	アプリのアイコンを生成するツール
icons8	アイコン、写真、音楽パッケージを閲覧するためのアプリ
iconscout	Iconscoutのデスクトップツールバー
iconset	アイコンセットとパックを1か所に整理
icq	メッセンジャーアプリケーション
id3-editor	MP3およびAIFFID3タグエディタ
idafree	バイナリコード分析ツール
idagio	クラシック音楽ストリーミングアプリ
idefrag	ディスクオプティマイザとデフラグツール
idisplay	iDisplay
idrive	iDrive
ieasemusic	サードパーティのNetEaseクラウドミュージックプレーヤー
iexplorer	iOSデバイスのバックアップソフトウェアとファイルマネージャー
ifunbox	iPhoneおよびその他のApple製品用のファイル管理ソフトウェア
igdm	InstagramDM用のデスクトップアプリケーション
igetter	フル機能のダウンロードマネージャーとアクセラレータ
iglance	ステータスバーのシステムモニター
igv	ゲノムデータの視覚的探索
iina	無料のオープンソースメディアプレーヤー
iina-plus	iinaの追加の弾幕サポート（iina 弾幕サポート）
ilok-license-manager	iLokデバイス用のソフトウェア
ilspy	Avaloniaベースの.NETデコンパイラー
ilya-birman-typography-layout	タイポグラフィキーボードレイアウト
image-tool	画像を拡大縮小し、画像ファイル形式を変換します
image2icon	アイコンクリエーターとファイルおよびフォルダーカスタマイザー
imagealpha	24ビットPNGファイルのサイズを縮小するユーティリティ
imagej	Javaでの画像処理と分析
imagemin	imagemin
imageoptim	画像をより小さなサイズに最適化するためのツール
imagex	画像コレクションを視覚的に探索して検索する
imazing	iPhone管理アプリケーション
imdone	プレーンテキストのマークダウンファイルまたはコードで動作するかんばんボード
imgotv	MangoTVビデオアプリ
immersed	VROffice用デスクトップエージェント
imo	Imoメッセンジャー
impactor	モバイルデバイスを操作するためのGUIツール
inav-configurator	INAV飛行制御システムの構成ツール
indigo	インディゴドモティクス
infinity	カスタマイズ可能な作業管理プラットフォーム
infoflow	AIオフィスプラットフォーム
inform	自然言語に基づくインタラクティブフィクションの書記体系
infra	Kubernetesデスクトップクライアント
inkdrop	Inkdrop
inkscape	ベクターグラフィックエディタ
inkstitch	機械刺繍デザイン用のInkscapeエクステンション
inky	インク用エディター：インクルの物語スクリプト言語
inloop-qlplayground	inloop-qlplayground
inso	CLIHTTPおよびGraphQLクライアント
insomnia	HTTPおよびGraphQLクライアント
inssider	inSSIDer
install-disk-creator	起動可能なシステムインストールディスクを作成するユーティリティ
instatus-out	メニューバーでサービスを監視する
insync	GoogleドライブとOneDriveファイルを管理する
integrity	壊れたリンクをチェックするウェブサイトをスキャンするツール
intel-haxm	ハードウェア支援仮想化エンジン（ハイパーバイザー）
intel-power-gadget	IntelCoreプロセッサで有効になっている電力使用量監視ツール
intel-psxe-ce-c-plus-plus	ソフトウェア開発ツール
intellidock	ドックがウィンドウと重なっているときにドックを非表示にします
intellij-idea	JetBrainsによるJavaIDE
intellij-idea-ce	Java開発用IDE-コミュニティ版
interarchy	ファイル転送ツール
internxt-drive	Internxtファイルストレージサービスのクライアント
intune-company-portal	企業のアプリ、データ、リソースへのアクセスを管理するアプリ
invesalius	3D医用画像再構成ソフトウェア
invisiblix	Finderで隠しファイルを表示および操作できます
invisionsync	InVision Sync
invisor-lite	メディアファイルインスペクター
invoker	Laravelアプリケーションを管理するためのユーティリティ
ionic-lab	IonicLab
ioquake3	ファーストパーソンシューティングエンジン
ios-app-signer	iOSアプリ署名者
ios-console	iOSコンソール
ios-saver	OSX用iOS8ロックスクリーン
iota-wallet	IOTAウォレット
ip-in-menu-bar	メニューバーに現在のIPアドレスを表示します
ipa-manager	IPAパレット
ipartition	ディスクパーティションツール
ipe	PDF形式で図を作成するための描画エディタ
ipepresenter	PDFからプレゼンテーションを作成する
ipfs	IPFSピアツーピアネットワーク用のメニューバーアプリケーション
iphoto-library-manager	複数のiPhotoライブラリ間で写真を整理するためのアプリ
ipremoteutility	FlandersScientificハードウェアの管理
ipsecuritas	IPSecクライアント
ipvanish-vpn	VPNクライアント
ipynb-quicklook	ipynb-quicklook
irccloud	IRCクライアント
ireadfast	速読プログラム
iridium	セキュリティとプライバシーに焦点を当てたWebブラウザ
iris	ブルーライトフィルターと目の保護ソフトウェア
iriunwebcam	携帯電話のカメラをワイヤレスWebカメラとして使用する
irpf2021	ブラジルの連邦歳入庁（RFB）の昨年の収入を宣言する
isabelle	一般的な証明アシスタント
ishowu	iShowU
ishowu-instant	リアルタイム画面録画
isimulator	シミュレータを制御および管理するためのユーティリティ
islide	PPTベースのプラグインツール
isolator	アイソレーター
istat-menus	システム監視アプリ
istat-server	コンピューターまたはサーバーの人口動態統計を送信します窶冱
isteg	暗号化ツール
istumbler	ワイヤレス検出ツール
isubtitle	字幕トラック、チャプターマーカー、メタデータをメディアに挿入します
iswiff	iSwiff
isyncer	AppleMusicプレイリストエクスポートツール
isyncr	USBまたはWiFi接続を介してiTunesをAndroidに同期します
itau	イタウ
itch	itch.ioのゲームクライアント
iterm2	Appleのターミナルアプリの代替としてのターミナルエミュレータ
ithoughtsx	マインドマッピングツール
itk-snap	3D医用画像のセグメント構造
itools	iTools
itraffic	ステータスバーにプロセストラフィックを表示するためのモニター
itsycal	メニューバーカレンダー
itubedownloader	YouTubeの動画、チャンネル、再生リストをダウンロードする
itunes-producer	書籍の詳細、価格、ファイルをAppleBooksに送信する
itunes-volume-control	キーボードの音量キーを使用してAppleMusicとSpotifyの音量を制御する
ivideonserver	Ivideonアカウントを介してブラウザで監視ビデオを見る
ivolume	すべての曲が同じ音量レベルで再生されることを保証するアプリ
ivpn	VPNクライアント
izip	ZIP、ZIPX、RAR、TAR、7ZIPおよびその他の圧縮ファイルを管理するためのアプリ
izotope-product-portal	オーディオ録音、ミキシング、放送などのためのプロフェッショナルオーディオソフトウェア
j	データの数学的、統計的、論理的分析のためのプログラミング言語
jabref	BibTeXファイルを編集、管理、検索するためのリファレンスマネージャー
jad	Javaデコンパイラ
jaikoz	オーディオタグエディタ
jalview	マルチプルアラインメントエディター、ビジュアライザー、分析および図ジェネレーター
jameica	SWT-UIを含むJavaで記述されたアプリケーションプラットフォーム
james	Webデバッグプロキシアプリケーション
jamf-migrator	JamfProサーバー間でデータをきめ細かく移行するためのツール
jami	分散型インスタントメッセンジャーとソフトフォン
jamkazam	低レイテンシーのリハーサル、妨害、パフォーマンス
jamovi	統計ソフトウェア
jamulus	友達とオンラインで音楽を再生する
jandi	JANDI
jandi-statusbar	ステータスバーのGithubコントリビューション
jasp	統計分析アプリケーション
jasper	GitHubの問題リーダー
jaxx-liberty	ブロックチェーンウォレット、保有物、暗号価格とニュース
jazzup	入力時に効果音を再生します
jbidwatcher	JBidwatcher
jbrowse	ゲノムブラウザ
jclasslib-bytecode-viewer	コンパイルされたJavaクラスファイルと含まれているバイトコードのすべての側面を視覚化します
jcryptool	暗号化アルゴリズムを適用して分析する
jd-gui	スタンドアロンJavaデコンパイラGUI
jdiskreport	ディスク使用ユーティリティ
jdk-mission-control	Javaアプリケーションを管理、監視、プロファイリング、トラブルシューティングするためのツール
jdownloader	ダウンロードマネジャー
jedit	テキストエディタ
jedit-omega	テキストエディタ
jellybeansoup-netflix	ブラウザの外部でNetflixを使用するサードパーティアプリ
jellyfin	メディアシステム
jellyfin-media-player	Jellyfinデスクトップクライアント
jenkins-menu	JenkinsCIサーバーのステータスを表示するメニュー項目
jet	サービスとしてのCI / CD
jetbrains-space	チームコミュニケーションおよびコラボレーションソフトウェア
jetbrains-toolbox	JetBrainsツールマネージャー
jettison	外付けドライブを自動的に排出します
jewelrybox	RVMマネージャー
jgrasp	ソフトウェアの理解度を向上させるための視覚化を備えたIDE
jgrennison-openttd	OpenTTDに適用されたパッチのコレクション
jietu	クイック注釈と共有スクリーンショットツール
jiggler	コンピューターをスリープ状態にしない
jitouch	マルチタッチジェスチャエディタ
jitsi	Jitsi
jitsi-meet	安全なビデオ会議アプリ
jmc	メディアオーガナイザー
joinme	join.me
joker	JokeriOSカーネルキャッシュ処理ユーティリティ
jollysfastvnc	JollysFastVNC
joplin	同期機能を備えたメモ取りとToDoアプリケーション
joshjon-nocturnal	薄暗い夜勤メニューバーアプリ
josm	OpenStreetMap用の拡張可能なエディター
journey	日記アプリ
jpadilla-rabbitmq	RabbitMQのアプリラッパー
jpadilla-redis	Redisのアプリラッパー
jprofiler	Javaプロファイラー
jqbx	他の人と同期してSpotifyの音楽を聴く
jt-bridge	WSJT-Xとアマチュア無線ロギングアプリケーション間のブリッジとして機能します
jtool	リバースエンジニアリング、セキュリティ研究者、および開発者の微調整を支援するツール
jtool2	リバースエンジニアリング、セキュリティ研究者、および開発者の微調整を支援するツール
jubler	字幕エディタ
julia	テクニカルコンピューティングのためのプログラミング言語
jump	リモートデスクトップアプリケーション
jump-desktop-connect	リモートデスクトップアプリ
jumpcut	クリップボードマネージャー
jumpshare	ファイル共有、画面記録、スクリーンショットキャプチャアプリ
jupyter-notebook-ql	JupyterNotebookクイックルック
jupyter-notebook-viewer	Jupyterノートブックをレンダリングするユーティリティ
jupyterlab	JupyterLab用のデスクトップアプリケーション
kactus	デザイナーのための真のバージョン管理ツール
kakapo	オープンソースのアンビエントサウンドミキサー
kaku	Kaku
kaleidoscope	テキストと画像のファイルまたはフォルダの違いを見つけてマージする
kap	Webテクノロジーで構築されたオープンソースのスクリーンレコーダー
kapitainsky-rclone-browser	Rcloneブラウザ
kapow	パンチクロックプログラム
karabiner-elements	キーボードカスタマイザー
katalon-studio	テスト自動化ソリューション
katana	オープンソースのスクリーンショットユーティリティ
katrain	ゲームを分析して遊ぶためのツールは、KataGoからのAIフィードバックに対応しています
kawa	代替入力ソーススイッチャー
kdiff3	ファイルとディレクトリを比較およびマージするためのユーティリティ
kdocs	Word、Excel、PPTドキュメント用のオンラインコラボレーションエディタ
kdrive	kDriveコラボレーティブクラウドストレージサービスのクライアント
keep	メニューバーでGoogleKeepを実行する
keep-it	ノートブック、スクラップブック、オーガナイザーツール
keepassx	セキュリティに焦点を当てたパーソナルデータマネージャー
keepassxc	パスワードマネージャーアプリ
keeper-password-manager	パスワードマネージャーアプリケーションとデジタルボールト
keepingyouawake	システムがスリープモードになるのを防ぐためのツール
keeweb	KeePassと互換性のあるパスワードマネージャー
keka	ファイルアーカイバ
kekaexternalhelper	Kekaファイルアーカイバのヘルパーアプリケーション
kern	パフォーマンスシンセサイザー
kext-updater	'Hackintoshes'に必要なカーネル拡張の自動アップデータ
kext-utility	Kext修復ツール
kextviewr	現在ロードされているすべてのkextを表示する
key-codes	任意のキーの組み合わせについて、キーコード、Unicode値、および修飾キーの状態を表示します
keybase	エンドツーエンド暗号化ソフトウェア
keyboard-cleaner	デスクトップシールドとキーストロークインターセプター
keyboard-lock	シンプルなキーボードロッカー
keyboard-maestro	自動化ソフトウェア
keyboardcleantool	すべてのキーボードとタッチバーの入力をブロックします
keyboardholder	アプリケーションごとに入力方法を切り替える
keycast	スクリーンキャストのキーストロークを記録する
keycastr	オープンソースのキーストロークビジュアライザー
keycombiner	インスタントショートカットルックアップ
keycue	キーボードショートカットを検索、学習、記憶します
keyfinder	音楽調検出ツール
keyman	別の言語で入力するようにキーボードを再構成します
keymanager	KeyManager
keypad-layout	Ctrlキーとテンキーを使用してウィンドウレイアウトを制御するユーティリティ
keyshot	KeyShot
keysmith	あらゆるもののカスタムキーボードショートカットを作成する
keystore-explorer	JavaコマンドラインユーティリティkeytoolおよびjarsignerのGUI置換
kicad	エレクトロニクス設計自動化スイート
kid3	効率を重視したオーディオタガー
kieler	グラフィカルモデルベースの設計ツール
kindavim	入力フィールドと非入力フィールドでVimを使用する
kindle	電子書籍を読んだり同期したりするためのインターフェース
kindle-comic-converter	電子ブックリーダー用のコミックとマンガのコンバーター
kindle-comic-creator	Kindleコミッククリエーター
kindle-previewer	Kindle電子書籍のプレビューと監査
kinza	ウェブブラウザ
kite	すべてのコードエディタにコード補完を追加します
kitematic	DockerContainer管理用のビジュアルユーザーインターフェイス
kitty	GPUベースのターミナルエミュレータ
kiwi-for-gmail	フル機能のデスクトップオフィス生産性アプリのようにGmailを強化します
kiwix	ウィキペディアや他の多くのウェブサイトへのオフラインアクセスを提供するアプリ
kkbox	音楽ストリーミングサービス
klatexformula	LaTeX方程式から画像を生成する
klayout	IC設計レイアウトビューアおよびエディタ
klogg	高速で高度なログエクスプローラー
klokki	自動タイムトラッキングソリューションまたはフリーランサーとメーカー
kmbmpdc	カワイイメニューバーミュージックプレーヤーデーモンコントローラー
kmeet	kMeetビデオ会議ソリューションのクライアント
kmplayer	ビデオプレーヤー
knime	データサイエンスを作成および生産するためのソフトウェア
knock	Knock
knockknock	コンピューターに永続的にインストールされているものを表示するツール
knotes	読書メモ管理ツール
knox	Knox
knuff	Appleプッシュ通知サービス（APN）のデバッグアプリケーション
koa11y	ウェブサイトのアクセシビリティの問題を簡単にチェック
koala	Koala
kobo	Kobo
kodelife	リアルタイムGPUシェーダーエディター
kodi	無料のオープンソースメディアプレーヤー
komet	Komet
komodo-edit	テキストエディタ
komodo-ide	すべての言語に対応した1つのIDE
koodo-reader	バックアップと復元をサポートするオープンソースのEpubリーダー
kotlin-native	KotlinのLLVMバックエンド
krisp	オンライン会議で明確に聞こえる
krita	無料のオープンソースの絵画とスケッチのプログラム
kryoflux	ホストソフトウェア-DiskToolConsole（dtc）およびUI
ksdiff	KaleidoscopeのAppStoreバージョン用のコマンドラインツール
ksnip	スクリーンショットと注釈ツール
kstars	天文学ソフトウェア
kube-cluster	kubeクラスター
kube-forwarder	kubeフォワーダー
kubecontext	Kubernetesコンテキストを管理するためのメニューバーアプリ
kubenav	ポケットの中にあるKubernetesクラスターのナビゲーター
kubernetic	Kubernetesデスクトップクライアント
kugoumusic	デジタル音楽サービス
kui	クラウドネイティブ開発のためのハイブリッドコマンドライン/UI開発経験
kvirc	IRCクライアント
kyokan-bob	名前オークションとDNSレコード管理のためのハンドシェイクウォレットGUI
lab	ReactUIコンポーネント設計ツール
lacona	Lacona
lagrange	Geminispaceを閲覧するためのデスクトップGUIクライアント
lando	Docker上に構築されたローカル開発環境とDevOpsツール
landrop	LAN上の任意のデバイスに任意のファイルをドロップします
lantern	Lantern
laravel-kit	デスクトップLaravel管理パネルアプリ
lark	プロジェクト管理ソフトウェア
lastfm	音楽サービスマネージャー
lastpass	パスワードマネージャー
latest	最新のアプリアップデートを表示するユーティリティ
latexdraw	LaTeXPSTricksコードを作成するための描画エディタ
latexit	LaTeXのグラフィカルインターフェイス
launchbar	生産性ツール
launchcontrol	システムおよびユーザーサービスの作成、管理、およびデバッグ
launchpad-manager	ランチパッドを管理するためのツール
launchrocket	LaunchRocket
launchy	ユーティリティデスクトップショートカットユーティリティ
laverna	Laverna
lazarus	迅速なアプリケーション開発のためのIDE
lazpaint	LazPaint
lazy	Lazy
lbry	分散型ファイル共有および支払いネットワークであるLBRYの公式クライアント
league-displays	リーグディスプレイ
league-of-legends	マルチプレイヤーオンラインバトルアリーナゲーム
leanote	Leanote
leap-motion	LeapMotion
leapp	クラウドクレデンシャルマネージャー
ledger-live	複数の暗号通貨を維持するためのウォレットデスクトップアプリケーション
leech	軽量ダウンロードマネージャー
leela	使いやすいグラフィカルインターフェイスでプログラムをプレイしてください
lego-digital-designer	仮想レゴブロックを使用してモデルを構築する
lego-mindstorms-ev3	レゴマインドストームEV3ホームエディション
lehreroffice	LehrerOffice
leksah	Haskell IDE
lens	Kubernetes IDE
leocad	仮想レゴモデルを作成するためのCADプログラム
lepton	スニペット管理アプリ
letter-opener	winmail.datファイルをMail.appに直接表示します
librecad	LibreCAD
libreelec-usb-sd-creator	LibreELECUSB-SDクリエーター
libreoffice	オフィススイート
libreoffice-language-pack	LibreOfficeの代替言語のコレクション
librepcb	プリント回路基板を開発するためのEDAソフトウェア
librewolf	ウェブブラウザ
licecap	アニメーションスクリーンキャプチャアプリケーション
license-control-center	eLicenserコントロールセンター
licensed	Licensed
liclipse	Eclipseの軽量エディター、テーマ設定、および使いやすさの向上
lidarr	ソナーのような見た目と匂いが音楽のために作られました
lifesize	lifesize
lightform	Lightformデバイス用のARプロジェクションおよびオーディオ反応性ソフトウェア
lightgallery	ライトギャラリー
lighting	通知センターウィジェットを介してLIFXライトを制御するツール
lightkey	DMX照明制御
lightproxy	Chrome DevtoolsUIを使用したホイッスルに基づくプロキシおよびデバッグツール
lighttable	IDE
lightworks	完全なビデオ作成パッケージ
lilypond	音楽彫刻プログラム
lincastor	リンクを開くときにWebブラウザを選択する
line-bot-designer	プロトタイプLINEボット
linear	Web開発を念頭に置いた定規アプリ
linear-linear	ソフトウェア開発を管理し、バグを追跡するためのアプリ
linearmouse	マウスの動作をカスタマイズする
lingon-x	アプリを起動したり、スクリプトやコマンドを実行したりするAutomatorソフトウェア
linkliar	macOS用のリンク層MACスプーフィングGUI
linphone	通信システム開発者向けソフトウェア
listen1	さまざまなオンラインソースから曲を検索して再生する
litecoin	暗号通貨ウォレット
liteicon	システムアイコンを変更するツール
liteide	IDEに移行
little-navmap	フライトプランニングとナビゲーション、空港検索と情報システム
little-snitch	ホストベースのアプリケーションファイアウォール
live-home-3d	ホーム＆フロアプランデザイナー＆レンダラー
livetail	Sumologic livetail CLI
lmms	音楽制作ソフトウェア
loading	ネットワークアクティビティモニター
loaf	アニメーションアイコンライブラリ
local	FlywheelによるWordPressローカル開発ツール
localdev	Localdev
localizationeditor	LocalizationEditor
locationsimulator	iOS、iPadOS、またはiPhoneSimulatorデバイスの場所を偽装するアプリケーション
lockdown	セキュリティ構成設定の監査と修正
lockrattler	セキュリティシステムをチェックし、問題を報告します
lofi	WebGLビジュアライゼーションを備えたミニSpotifyプレーヤー
logdna-agent	エージェントはログファイルからLogDNAアカウントにストリーミングします
logdna-cli	LogDNA CLI
logicalshift-zoom	Zコード、TADS、およびHUGOのストーリーまたはゲーム用のプレーヤー
logicsniffer	Open Bench LogicSnifferロジックアナライザハードウェアのソフトウェアクライアント
loginputmac	中国語入力方式
logisim	デジタル論理回路を設計およびシミュレーションするためのツール
logisim-evolution	デジタルロジックデザイナーおよびシミュレーター
logitech-presentation	Logitechプレゼンテーション
logmein-client	リモートアクセスツール
logmein-hamachi	LogMeIn Hamachi
logos	聖書研究ソフトウェア
logseq	知識の共有と管理のためのプライバシー第一のオープンソースプラットフォーム
lookin	Lookin
loom	画面およびビデオ録画ソフトウェア
loopback	ケーブルフリーオーディオルーター
losslesscut	ビデオファイルとオーディオファイルをロスレスでトリミング
love	Lua用の2Dゲームフレームワーク
lrtimelapse	タイムラプス編集、キーフレーム、グレーディング、レンダリング
ltspice	SPICEシミュレーションソフトウェア、回路図キャプチャ、波形ビューア
ludwig	あなたがより良い英語を書くのを助ける文検索エンジンアプリ
lulu	未知の発信接続をブロックするオープンソースファイアウォール
lumen	画面の内容に基づく魔法の自動明るさ
luminance-hdr	HDRイメージングのワークフローを提供します
lunar	外部ディスプレイの適応輝度
lunar-client	Minecraft1.7.10および1.8.9用のModpack
lunasea	メディアソフトウェア用のオープンソースのセルフホストリモコン
lunastudio	Lunaスタジオ
luxmark	OpenCLベンチマーク
luyten	Procyon用のオープンソースJava逆コンパイラGUI
lx-music	Electron＆Vueをベースにした音楽アプリ
lycheeslicer	レジン3Dプリンター用スライサー
lyn	Lyn
lynkeos	天文ウェブカメラ画像処理ソフトウェア
lynx	クロスプラットフォームのプレゼンテーションと生産性アプリ
lynxlet	ターミナルウィンドウでLynxを起動する
lyrics-master	歌詞を見つけてダウンロードする
lyricsx	iTunes、Spotify、Vox、AudirvanaPlusの歌詞
lyx	LaTeX植字システムに基づくオープンソースのGUIドキュメントプロセッサ
m3unify	M3Unify
mac2imgur	mac2imgur
macbreakz	健康上の問題を防ぐための人間工学的アシスタント
maccleaner-pro	ジャンク、不要なファイルやフォルダを削除し、コンピュータを高速化します
maccpuid	CPUID命令で情報を表示します
maccy	クリップボードマネージャー
macdependency	MacDependency
macdive	デジタルダイビングログ
macdjview	MacDjView
macdown	オープンソースのMarkdownエディター
macdroid	Androidデバイスに接続します
macdropany	ローカルフォルダをクラウドと同期します
macfuse	ファイルシステム統合
macfusion	Macfusion
macfusion-ng	Macfusion
macgamestore	ゲームを購入、ダウンロード、およびプレイする
macgdbp	実行中のPHPアプリケーションのライブでインタラクティブなデバッグ
macgesture	グローバルなマウスジェスチャーを設定するユーティリティ
machacha	MacHacha
machg	MacHg
machoexplorer	Mach-O実行可能ファイルエクスプローラー
machoview	VisualMach-Oファイルブラウザ
maciasl	ACPI機械語（AML）コンパイラとIDE
macintoshjs	Electronで実行されているSystem8を搭載した仮想AppleMacintosh
macjournal	ジャーナリングおよびブログソフトウェア
macloggerdx	アマチュア無線ロギングおよびリグ制御ソフトウェア
macmediakeyforwarder	iTunesとSpotifyのメディアキーフォワーダー
macmorpheus	PSVRを使用した3D180 / 360ビデオプレーヤー
macpar-deluxe	ダウンロード後にバイナリコンテンツファイルを結合するユーティリティ
macpass	オープンソース、KeePass-クライアントおよびパスワードマネージャー
macpilot	コマンド端末のグラフィカルユーザーインターフェイス
macrorecorder	マウスとキーボードのアクションを記録する
macs-fan-control	Appleコンピュータのすべてのファンを制御および監視します
macstroke	構成可能なグローバルマウスジェスチャー
macsvg	macSVG
macterm	MacTerm
mactex	GUIアプリケーションを使用した完全なTeXLiveディストリビューション
mactex-no-gui	GUIアプリケーションを使用しない完全なTeXLiveディストリビューション
mactracker	これまでに製造されたすべてのアップル製品に関する詳細情報
macupdate	MacUpdateデスクトップ
macupdater	インストールされているソフトウェアの最新バージョンを追跡して更新します
macvim	テキストエディタ
macwinzipper	Zipアーカイバ
macx-dvd-ripper-mac-free-edition	MacXDVDリッパーMac無料版
macx-dvd-ripper-pro	DVDリッピングアプリケーション
macx-video	4Kビデオ処理ソフトウェア
macx-video-converter-pro	ビデオを変換、編集、ダウンロード、サイズ変更するためのツール
macx-youtube-downloader	YouTubeからビデオをダウンロードするためのツール
maczip	アーカイブファイルを開いたり、作成したり、変更したりするためのユーティリティ
maczip4win	MacZip4Win
maelstrom	多方向シューティングゲーム
maestral	オープンソースのDropboxクライアント
magicavoxel	8ビット3Dボクセルエディターとインタラクティブパストレーシングレンダラー
magiccap	画像/ GIFキャプチャスイート
magicplot	非線形フィッティング、プロット、データ分析のためのソフトウェア
mailbutler	AppleMailのパーソナルアシスタントおよび生産性向上ツール
mailmaster	メールクライアント
mailmate	IMAPメールクライアント
mailplane	Gmailクライアント
mailspring	NylasMailのフォーク
mailtrackerblocker	メールトラッカー、開封確認、AppleMail用スパイピクセルブロッカープラグイン
maintenance	オペレーティングシステムのメンテナンスとクリーニングユーティリティ
majsoul-plus	Majsoulプラス
makehuman	3Dキャラクターを作成するためのオープンソースツール
makemkv	ビデオフォーマットコンバーター（トランスコーダー）
maltego	オープンソースインテリジェンスおよびグラフィカルリンク分析ツール
malus	さまざまなオンラインメディアリソース/サービスへのアクセスを支援するプロキシ
malwarebytes	マルウェア、アドウェア、スパイウェアについて警告します
mambaforge	Mambaのサポートがプリインストールされたcondaの最小限のインストーラー
mame	多目的エミュレーションフレームワークの移植
mamp	Apache、Nginx、PHP、MySQLを使用したWeb開発ソリューション
mana-security	個人の脆弱性管理
manageengine-mibbrowser	ManageEngine MibBrowser
manico	アプリランチャーとスイッチャー
manictime	コンピューターの使用状況データを自動的に収集するタイムトラッカー
manta	カスタマイズ可能なテンプレートを使用した請求書発行デスクトップアプリ
manuskript	作家のためのツール
manyverse	ピアツーピアSSBプロトコルに基づいて構築されたソーシャルネットワーク
mapture	Mapture
marathon	三部作で最初の一人称シューティングゲーム
marathon-infinity	三部作で3番目の一人称シューティングゲーム
marathon2	三部作で2番目の一人称シューティングゲーム
marble	Marble
marginnote	電子リーダー
mari0	Mari0
maria	aria2ダウンロードツール用のアプリ/ウィジェット
mark-text	テキストをマークする
markdown-service-tools	マークダウン形式のテキストのサービスのコレクション
markdownmdimporter	MarkdownSpotlightプラグイン
marked	Markdown、MultiMarkdown、その他のテキストマークアップ言語のプレビューア
markright	ライブプレビュー付きの電子駆動マークダウンエディター
mars	MipsAssemblyおよびRuntimeSimulator
marsedit	ブログを作成、プレビュー、公開するためのツール
marshallofsound-google-play-music-player	GooglePlayミュージックデスクトッププレーヤー
marta	拡張可能な2ペインのファイルマネージャー
marvel	プロトタイピング、テスト、ハンドオフツール
marvin	個人の生産性アプリ
masscode	開発者向けのオープンソースコードスニペットマネージャー
massreplaceit	MassReplaceIt
master-pdf-editor	PDFエディター
mat	Javaヒープアナライザ
mate-translate	任意のアプリでテキストを選択して翻訳します
mater	Mater
material-colors	Mac用の素材の色
mathcha-notebook	数学エディタ
mathpix-snipping-tool	数学と科学のためのスキャナーアプリ
mathtype	MathType
matterhorn	Mattermost用のUnixターミナルクライアント
mattermost	オープンソースのセルフホストSlack-alternative
mattr-slate	Slate
mauve	Mauve
mavensmate	MavensMateサーバー用のパッケージデスクトップアプリ
max	CDやファイルからさまざまな形式の高品質オーディオファイルを作成します
maxon	Maxon製品をインストール、使用、およびお試しください
mbed-studio	MbedOSアプリケーションおよびライブラリ開発用のIDE
mblock	STEAMを教えるために設計されたコーディングツール
mcbopomofo	注音符号（北京語の発音記号）の入力方法
mcedit	Minecraftワールドエディター
mcgimp	再コンパイルされたGIMPインストール
mcreator	Minecraft JavaEditionのmodを作成するために使用されるソフトウェア
mdimagesizemdimporter	mdImageSize
mdrp	DVDコンテンツをリッピングしてコピーするユーティリティ
mds	IntelとAppleのシリコンMacを数秒で導入
mechvibes	入力時にメカニカルキーボードのサウンドを再生します
media-center	メディアを管理および再生する
media-converter	avi、wmv、mkv、rm、movなどを他の形式に変換します
mediaelch	Kodiのメディアマネージャー
mediahuman-youtube-downloader	YouTubeビデオダウンローダー
mediainfo	ビデオおよびオーディオファイルの技術データとタグデータを表示する
mediathekview	ドイツ、オーストリア、スイスの公共放送のオンラインマルチメディアライブラリを管理します
medibangpaintpro	デジタルアートとコミックを作成する
meetingbar	メニューバーに次の会議を表示します
megacmd	MEGAcmd
megasync	コンピューターとMEGAクラウドドライブ間でファイルを同期します
megax	分子進化統計分析と系統樹の構築
megazeux	ASCIIベースのゲーム作成システム
meld	ビジュアル差分およびマージツール
mellow	ルールベースのグローバル透過プロキシクライアント
mellowplayer	gitlabに移動しました
melodics	楽器の演奏を学ぶのに役立ちます
melonbooksviewer	メロンブックス 電子書籍
melonds	ニンテンドーDSおよびDSiエミュレーター
mem	どこからでも情報を取得してアクセスできます
memo	GitHubGistsを使用してアプリを取得することに注意してください
memory	タイムトラッキングソフトウェア
memory-clean-3	メモリクリーニングユーティリティ
memory-cleaner	RAMを手動および自動で解放します
memory-map	GPSナビゲーションソフトウェア
mendeley	研究管理ツール
mendeley-reference-manager	研究管理ツール
menu-bar-splitter	メニューバーに仕切りを追加するユーティリティ
menubar-colors	システムのカラーパネルに簡単にアクセスできるメニューバーアプリ
menubar-countdown	メニューバーのカウントダウンタイマー
menubar-stats	温度とファンのプラグインを備えたシステムモニター
menucalendarclock-ical	MenuCalendarClock
menumeters	CPU、メモリ、ディスク、およびネットワーク監視ツールのセット
menutube	YouTubeをメニューバーに取り込むためのツール
menuwhere	どこからでもメニューにアクセス
merlin-project	プロジェクト管理アプリケーション
mesasqlite	SQLite3データベースを作成、設計、変更する
meshlab	メッシュ加工システム
messenger	メッセンジャー用のネイティブデスクトップアプリ（以前のFacebookメッセンジャー）
messenger-native	Facebookのメッセンジャーネイティブ
messenger-unofficial	メッセンジャー
meta	デジタル音楽用のタグエディタ
metabase	ビジネスインテリジェンスと分析
metaimage	画像メタデータの読み取り、書き込み、編集を行うエディター
metashape	デジタル画像を処理し、3D空間データを生成します
metashapepro	デジタル画像を処理し、3D空間データを生成します
metasploit	侵入テストフレームワーク
metaz	Mp4メタデータエディタ
meteorologist	調整可能な天気表示アプリケーション
mgba	ゲームボーイアドバンスエミュレータ
mi	テキストエディタ
mia-for-gmail	Gmail用のデスクトップメールクライアント
mic-drop	グローバルショートカットまたはメニューバーコントロールを使用して、マイクをすばやくミュートします
michaelvillar-timer	タイマーアプリケーション
micro-sniff	マイクのアクティビティを監視する
micro-snitch	マイクとカメラのアクティビティを監視および報告します
microblog	マイクロブログとソーシャルネットワーキングサービス
microsoft-auto-update	さまざまなMicrosoft製品の更新を提供します
microsoft-azure-storage-explorer	AzureStorageのエクスプローラー
microsoft-edge	ウェブブラウザ
microsoft-excel	表計算ソフトウェア
microsoft-office	オフィススイート
microsoft-openjdk	MicrosoftからのOpenJDKディストリビューション
microsoft-outlook	メールクライアント
microsoft-powerpoint	プレゼンテーションソフトウェア
microsoft-remote-desktop	リモートデスクトップクライアント
microsoft-teams	たった1つの場所で出会い、チャット、電話、コラボレーション
microsoft-word	ワードプロセッサ
middle	トラックパッドとマジックマウスのミドルクリックを追加
middleclick	トラックパッド機能を拡張するユーティリティ
midi-monitor	コンピューターに出入りするMIDI信号を表示する
midi-router-client	どこからでもどこへでもルートを作成
midikeys	MidiKeys
midistroke	midiStroke
miditrail	MIDIデータセットの3D視覚化を提供するMIDIプレーヤー
midiview	MIDI入力と出力を監視する
mightymike	Pangea Software（別名Power Pete）のトップダウンアクションゲーム
mikogo	Mikogo
miktex-console	TeXディストリビューション
milanote	アイデアやプロジェクトをビジュアルボードに整理します
milkman	拡張可能な要求および応答ワークベンチ
milkytracker	FT2と互換性のあるミュージックトラッカー
millie	韓国の電子書籍ストア
mimecast	Mac用のMimecast
mimestream	Gmail用のネイティブアプリのメールクライアント
min	プライバシーを保護する最小限のブラウザ
mindforger	ThinkingNotebookとMarkdownIDE
mindjet-mindmanager	マインドマッピングツール
mindmaster	マインドマスター
minecraft	サンドボックス建設ビデオゲーム
minecraft-server	Minecraftマルチプレイヤーサーバーを実行する
minecraftpe	Minecraftの教育版
mini-program-studio	Alipayアプレットの開発のためのIDE
mini-vmac	最新のコンピュータが初期のAppleコンピュータ用に作られたソフトウェアを実行できるようにします
miniconda	condaの最小限のインストーラー
miniforge	conda-forgeに固有のcondaの最小限のインストーラー
minishift	Minishift
minitimer	miniTimer
minitube	YouTubeアプリケーション
minizincide	オープンソースの制約モデリング言語とIDE
mipony	Mipony
miro	オンラインコラボレーティブホワイトボードプラットフォーム
mirrordisplays	ミラーディスプレイ
mirrorop	wePresentシステム用のミラーリングソフトウェアアプリケーション
mission-control-plus	MissionControlでウィンドウを管理する
missive	チームの受信トレイとチャットツール
mit-app-inventor	MIT App Inventor
mixed-in-key	DJと音楽プロデューサーのためのハーモニックミキシング
mixxx	オープンソースのDJソフトウェア
mjml	MJML用デスクトップアプリ
mjolnir	軽量の自動化と生産性のアプリ
mkchromecast	オーディオ/ビデオをGoogleCastおよびSonosデバイスにキャストするためのツール
mks	メカニカルキーボードシミュレーター
mkvtoolnix	Matroskaファイル（MKV）を作成、変更、検査するためのツールのセット
mkvtools	MKVビデオを作成および編集するためのアプリ
mmex	お金の管理アプリケーション
mmhmm	仮想ビデオプレゼンテーションソフトウェア
mnemosyne	フラッシュカードツール
mob	Mob
mobirise	ノーコードウェブサイトクリエーター
mobster	ペアと暴徒のプログラミングタイマー
mochi	間隔反復を使用した研究ノートとフラッシュカード
mockoon	ローカルでモックAPIを作成する
mockplus	moc 
mockuuups-studio	デザイナーやマーケターがビジュアルをシーンにドラッグアンドドロップできるようにします
modelio	拡張可能なモデリング環境
modern-csv	CSVエディター
modmove	モディファイアとマウスを使用してウィンドウを移動/サイズ変更するユーティリティ
moebius	ANSIエディター
moefe-google-translate	MoeFEGoogle翻訳
mojibar	メニューバーアプリとしての絵文字サーチャー
molotov	フランスのテレビストリーミングサービス
monal	チャットサーバーに安全に接続するためのツール
monero-wallet	追跡不可能な暗号通貨ウォレット
moneydance	プライバシーに焦点を当てた個人の財務管理アプリケーション
moneymoney	ドイツの銀行および財務管理ソフトウェア
moneywiz	財務管理アプリケーション
mongodb-compass	MongoDBデータを探索して操作する
mongodb-compass-isolated-edition	MongoDBデータを探索して操作する
mongodb-compass-readonly	MongoDBデータを探索して操作する
mongodb-realm-studio	レルムデータベースおよびレルムプラットフォーム用のツール
mongodbpreferencepane	MongoDB-PrefsPane
mongotron	MongoDB管理
monitorcontrol	外部モニターの明るさと音量を制御するツール
monity-helper	モニティヘルパー
mono-mdk	Microsoftの.NETFrameworkのオープンソース実装
monodraw	テキストベースのアートを作成するためのツール
monolingual	システムから不要な言語リソースを削除するユーティリティ
monterey-cache-cleaner	汎用システム保守ツール
moom	1つのディスプレイでウィンドウを移動およびズームするユーティリティ
moonlight	GameStreamクライアント
moose	moose
moradownloader	日本市場向けのオンライン音楽およびビデオストア
morkro-papyrus	非公式のDropboxPaperデスクトップアプリ
morpheus	多細胞システム生物学のモデリング環境
mos	スクロールをスムーズにし、マウスのスクロール方向を個別に設定します
mosaic	アプリのサイズ変更と再配置
moscow-ml	StandardMLの軽量実装
motrix	オープンソースのダウンロードマネージャー
mountain	ボリュームのマウント/アンマウント時に通知を表示する
mountain-duck	サーバーとクラウドストレージをディスクとしてデスクトップにマウントします
mounty	書き込み保護されたNTFSボリュームを再マウントします
mouse-fix	サードパーティのマウスにジェスチャー機能とスムーズなスクロールを追加するためのマウスユーティリティ
mouse-locator	マウスロケーター
mousepose	マウスポインタとカーソル位置を強調表示します
movist	QuickTimeとFFmpegをベースにしたムービープレーヤー
movist-pro	メディアプレーヤー
mp3gain-express	MP3Gain Express
mp4tools	MP4ビデオの作成と編集
mpeg-streamclip	ビデオコンバーター、プレーヤー、エディター
mplab-xc16	16ビットPICおよびSAMMCUおよびMPU用のコンパイラ
mplab-xc32	32ビットPICおよびSAMMCUおよびMPU用のコンパイラ
mplab-xc8	8ビットPICおよびSAMMCUおよびMPU用のコンパイラ
mplabx-ide	マイクロチップのマイクロコントローラーとデジタル信号コントローラー用のIDE
mplayer-osx-extended	バックエンドとしてMPlayerを使用するビデオプレーヤー
mplayerx	メディアプレーヤー
mps	独自のドメイン固有言語を作成する
mpv	MPlayerとmplayer2に基づくメディアプレーヤー
mqtt-explorer	MQTT Explorer
mqttfx	MQTT.fx
mqttx	クロスプラットフォームのMQTT5.0デスクトップクライアント
mtgaprotracker	高度な魔法：ギャザリングアリーナ追跡ツール
mtmr	私のタッチバー。私のルール
mu-editor	初心者のPythonプログラマー向けの小さくてシンプルなエディター
mubu	メモ取りと管理アプリの概要
mucommander	デュアルペインインターフェイスを備えたファイルマネージャー
mudlet	マルチユーザーダンジョンクライアント
mullvadvpn	VPNクライアント
multi	ウェブサイトのグループからアプリを作成する
multibit-hd	マルチビットHD
multifirefox	MultiFirefox
multimc	マインクラフトランチャー
multipass	仮想Ubuntuインスタンスを調整します
multipatch	ファイルパッチユーティリティ
multiscan-3b	マルチスキャン3B
multitouch	トラックパッドとマジックマウスのジェスチャーを追加する
mumble	ゲーム用のオープンソース、低遅延、高品質のボイスチャットソフトウェア
mumu	Mumu
munki	ソフトウェアインストールマネージャー
munkiadmin	Munkiリポジトリを管理するためのツール
mural	ビジュアルオンラインコラボレーションプラットフォーム
murus	ファイアウォールアプリ
murus-menulet	Murusファイアウォール
muruslogsvisualizer	Murus Logs Visualizer
musaicfm	SpotifyまたはLast.fmのプロファイルデータに基づいてアートワークを表示するスクリーンセーバー
muse	TouchBarをサポートするオープンソースのSpotifyコントローラー
museeks	音楽プレーヤー
musescore	オープンソースの楽譜作成ソフトウェア
music-bar	メニューバーから直接AppleMusicを制御する
music-manager	GooglePlayミュージックマネージャー
musicbrainz-picard	音楽タガー
musictube	ストリーミング音楽プレーヤー
mutespotifyads	MuteSpotifyAds
mutesync	mütesync物理ボタンへのコンパニオンアプリ
mutify	ミューティファイ
muzzle	画面共有中に困惑する通知を黙らせる
mweb-pro	マークダウン書き込み、メモ取り、静的ブログジェネレーターアプリ
mxsrvs	ANMP（Apache、Nginx、MySQL、PHP）統合開発環境
my-budget	予算編成ツール
my-image-garden	写真編集および印刷ツール
mycloud	スイスのクラウドストレージデスクトップアプリ
mycrypto	イーサリアムウォレットマネージャー
mylio	Mylio
mymonero	Monero暗号通貨のウォレット
myphone	myPhoneDesktop
mysides	mysides
mysql-connector-python	MySQLサーバーと通信するための自己完結型のPythonドライバー
mysql-shell	インタラクティブなJavaScript、PythonまたはSQLインターフェース
mysql-utilities	MySQLユーティリティ
mysqlworkbench	MySQLサーバーを設計、開発、管理するためのビジュアルツール
n1ghtshade	32ビットiOSデバイスのダウングレード/ジェイルブレイクを許可します
nagbar	Nagios、Icinga/2、Thrukのステータスバーモニター
nagstamon	Nagiosステータスモニター
nally	マンダリンBBS用に最適化された美しいtelnet/sshクライアント
name-mangler	複数ファイルの名前変更ツール
namebench	DNSサーバーファインダー
namechanger	ファイルのリストの名前をすばやく変更する
nano	Nano暗号通貨のローカルノード
nanosaur	PangeaSoftwareのサイエンスフィクションサードパーソンシューティングゲーム
nanostudio	NanoStudio
nasas-eyes	NASAの目
native-access	NativeInstruments製品の管理ツール
nativedisplaybrightness	NativeDisplayBrightness
natron	オープンソースのノードグラフベースのビデオ合成ソフトウェア
nault	ハードウェアウォレットをサポートするNano暗号通貨用のウォレット
nautilus	Nautilus
naver-whale	ウェブブラウザ
navicat-data-modeler	データベース設計ツール
navicat-data-modeler-essentials	データベース設計ツール
navicat-for-mariadb	MariaDB用のデータベース管理および管理ツール
navicat-for-mysql	データベース管理および開発ツール
navicat-for-oracle	Oracle用のデータベース管理および開発ツール
navicat-for-postgresql	PostgreSQL用のデータベース管理および開発ツール
navicat-for-sql-server	SQLサーバー用のデータベース管理および開発ツール
navicat-for-sqlite	SQLite用のデータベース管理および開発ツール
navicat-premium	データベース管理および開発ツール
navicat-premium-essentials	データベース管理および開発ツール
nbtexplorer	Minecraft用の名前付きバイナリタグ（NBT）データエディタ
ncar-ncl	科学データの分析と視覚化のための通訳言語
ndm	Node.jsパッケージマネージャー（NPM）のデスクトップマネージャー
neat-reader	ePubの本を読み、注釈を付け、管理する
neo4j	Neo4jインスタンス用の開発者IDEまたは管理環境
neofinder	デジタルメディアアセットマネージャー
nestopia	ファミコン（NES）エミュレータ
netbeans	開発環境、ツールプラットフォーム、アプリケーションフレームワーク
netdownloadhelpercoapp	Webからのビデオダウンロードを許可します
neteasemusic	音楽ストリーミングプラットフォーム
nethackcocoa	NetHackCocoa
netiquette	ネットワークモニター
netlogo	マルチエージェントプログラマブルモデリング環境
netnewswire	無料のオープンソースRSSリーダー
netron	ニューラルネットワーク、深層学習、機械学習モデル用のビジュアライザー
netspot	WiFiサイト調査ソフトウェアとWiFiスキャナー
network-radar	ネットワークをスキャンおよび監視するためのツール
netxms-console	ネットワークとインフラストラクチャの監視および管理システム
next	次のブラウザ
nextcloud	Nextcloudソフトウェア製品用のデスクトップ同期クライアント
nfov	ASCII/ANSIアートビューア
ngrok	リバースプロキシ、ローカルホストへの安全なイントロスペクト可能なトンネル
nheko	Matrixプロトコル用のデスクトップクライアント
nifty	ニフティ
niftyman	メニューバーから概念ツールにアクセスします
night-owl	Twitterクライアントアプリ
nightfall	ダークモードを切り替えるためのメニューバーユーティリティ
nightingale	Songbirdのコミュニティフォークの作業ツリー
nightowl	ダークモードを切り替えるユーティリティ
nimble-commander	デュアルペインファイルマネージャー
nimblenote	キーボードによるメモを取る
nimbus	スタンドアロンIRCCloudデスクトップクライアント
ninja-download-manager-ndm	ファイルダウンロードオーガナイザーとアクセラレータ
nisus-thesaurus	「サービス」メニュー用の電子シソーラス
nitroshare	ネットワークファイル転送アプリケーション
no-ip-duc	現在のIPアドレスの同期を維持します
nocturn	マルチプラットフォームのTwitterクライアント
nocturnal	ワンクリックでダークモードを切り替えるシンプルなアプリ
nocturne	暗い場所に合わせてディスプレイの色を調整します
nodebox	視覚化とジェネレーティブデザインのためのノードベースのデータアプリケーション
nodeclipse	ノードクリップ
noisebuddy	NoiseBuddy
noisy	ホワイトノイズジェネレータ
noisytyper	騒々しいタイパー
nomachine	リモートデスクトップソフトウェア
nomachine-enterprise-client	リモートデスクトップソフトウェア
nomad	NoMAD
nordlayer	ビジネス向けセキュリティソフトウェア
nordlocker	ファイルを安全に保存および同期する
nordpass	クレデンシャルを1つの場所に保存し、オフラインの場合でも任意のデバイスにログインします
nordvpn	安全なインターネットアクセスとプライベートブラウジングのためのVPNクライアント
northernspysoftware-colorpicker	どこでもAppleカラーピッカーを使用するユーティリティ
nosleep	ふたを閉めたときに眠りを防ぐカーネル拡張
nosql-workbench	最新のデータベース開発および運用のためのクライアント側GUIアプリケーション
nosqlbooster-for-mongodb	MongoDB用のGUIツールとIDE
not-pacman	パックマンではない
not-tetris	テトリスではない
nota	マークダウンファイルエディタ
notable	吸わないマークダウンベースのメモ取りアプリ
notational-velocity	表記速度
notch-simulator	MacBookProのノッチをシミュレートする
notebooks	ワードプロセッサ
notedup	NoteDup
noti	Androidデバイスからの通知を表示するユーティリティ
notion	書き、計画し、コラボレーションし、整理するためのアプリ
notion-enhanced	オールインワンの生産性ワークスペースnotion.soのエンハンサー/カスタマイザー
noto	シンプルなプレーンテキストエディタ
notunes	iTunesやAppleMusicの起動を妨げるシンプルなアプリケーション
noun-project	アイコンマネージャー
nova	ネイティブコードエディタ
novabench	コンピューターのパフォーマンスをすばやくテストして比較するためのベンチマークツール
now	トレイメニューから直接デプロイメントを作成する
now-tv-player	ビデオストリーミングサービスプレーヤー
noxappplayer	モバイルゲームをプレイするためのAndroidエミュレーター
nozbe-personal	タスクマネージャー
nrlquaker-winbox	MikroTik Winbox
nslogger	最新の柔軟なロギングツール
nsregextester	NSRegexTester
nteract	インタラクティブコンピューティングスイート
ntfstool	NTFSの読み取りおよび書き込みサポートを提供するユーティリティ
nuage	無料のオープンソースSoundCloudクライアント
nuclear	ストリーミング音楽プレーヤー
nucleo	アイコンマネージャーとライブラリ
nuclino	コラボレーティブウィキとナレッジベース
nudge	OSアップデートを実施するためのアプリケーション
nulloy	音楽プレーヤー
nullpomino	アクションパズルゲーム
numi	電卓およびコンバーターアプリケーション
nutstore	Nutstore
nvalt	アプリを取ることに注意してください
nvidia-geforce-now	クラウドゲームプラットフォーム
nwjs	すべてのNode.jsモジュールをDOMおよびWebワーカーから直接呼び出します
nzbget	効率に焦点を当てたUsenetダウンローダー
nzbvortex	パフォーマンスと使いやすさのために最適化されたNZBクライアント
objectivesharpie	Objective-Cコードから始まるC＃インターフェイスを生成するために使用されるツール
objektiv	Objektiv
obs	ライブストリーミングと画面録画用のオープンソースソフトウェア
obs-ndi	OBSStudio用のNewTekNDI統合
obs-virtualcam	OBSバーチャルカメラ
obs-websocket	WebSocketを介したOBSStudioのリモートコントロール
obsidian	プレーンテキストのマークダウンファイルのローカルフォルダの上で機能するナレッジベース
ocenaudio	オーディオエディタ
oclint	静的ソースコード分析ツール
octomouse	OctoMouse
odbc-manager	ODBC管理者
odrive	クラウドストレージを統合、同期、共有、暗号化するためのツール
offset-explorer	ApacheKafkaクラスターを管理および使用するためのGUI
ogdesign-eagle	すべての参照画像を1か所に整理
okta-advanced-server-access	IDおよびアクセス管理
old-school-runescape	Old SchoolRuneScapeのゲームクライアント
olive	ノンリニアビデオエディタ
omegat	OmegaT
omnidazzle	画面とマウスポインタの領域を強調表示するプラグインのセット
omnidb	データベース管理用のWebツール
omnidisksweeper	大きな不要なファイルを見つけて削除します
omnifocus	組織に焦点を当てたアプリケーションのスケジューリング
omnigraffle	ビジュアルコミュニケーションソフトウェア
omnioutliner	アプリケーションと情報オーガナイザーを取ることに注意してください
omniplan	プロジェクト計画および管理ソフトウェア
omnipresence	ドキュメント同期アプリケーション
ondesoft-audiobook-converter	オーディオブックコンバーター
one-switch	すべてのシステムスイッチとユーティリティスイッチを1か所に
onecast	OneCast
onedrive	クラウドストレージクライアント
onenote-importer-preview	OneNoteインポーター（プレビュー）
onepile	OnePile
onionshare	安全かつ匿名でファイルを共有し、Webサイトをホストし、友人とチャットします
only-switch	システムおよびユーティリティスイッチ
onlyoffice	ドキュメントエディタ
onyx	システムファイルの構造を確認し、その他のメンテナンスを実行します。
oolite	oolite
open-in-code	Visual StudioCodeで現在のフォルダーを開くためのFinderツールバーアプリ
open-video-downloader	Electronとnode.jsで作成されたyoutube-dl用のクロスプラットフォームGUI
openarena	OpenArena
openaudible	Audibleユーザー向けのオーディオブックマネージャー
openbazaar	OpenBazaar＃{version.major}
openbci	OpenBCIハードウェアに接続し、生理学的データを視覚化してストリーミングします
openboard	インタラクティブホワイトボードアプリケーション
openboardview	OpenBoardView
openconnect-gui	GitLabミラー-グラフィカルOpenConnectクライアント（ベータフェーズ）
opencore-configurator	OpenCoreEFIブートローダー構成ヘルパー
opencpn	フル機能で簡潔なChartPlotter/Navigator
opendnsupdater	動的IPアップデータクライアント
openemu	レトロなビデオゲームエミュレーション
openframeworks	クリエイティブコーディング用のC++ツールキット
openin	特定のブラウザ/アプリでリンク/ファイルを開く
openineditor-lite	Finderで現在のディレクトリを開くためのFinderツールバーアプリ
openinterminal	ターミナルまたはエディタで現在のディレクトリを開くためのFinderツールバーアプリ
openinterminal-lite	ターミナルで現在のディレクトリを開くためのFinderツールバーアプリ
openkey	ベトナム語入力システム
openloco	ChrisSawyerのLocomotionのオープンソースによる再実装
openlp	礼拝プレゼンテーションソフトウェア
openmsx	MSXエミュレータ
openmtp	Androidファイル転送
openmw	MorrowindのプレイをサポートするオープンソースのオープンワールドRPGゲームエンジン
openoffice	無料のオープンソース生産性スイート
openphone	専門家、チーム、および企業向けのビジネスフォン
openpht	プレックスホームシアターのコミュニティ主導のフォーク
openra	Westwoodゲーム用のリアルタイム戦略ゲームエンジン
openrct2	RollerCoaster Tycoon2のオープンソースの再実装
openrefine	乱雑なデータを操作するためのツール（以前のGoogle Refine）
opensc	スマートカードライブラリとユーティリティ
openscad	プログラム可能なソリッド3DCADモデラー
opensesame	社会科学のためのグラフィカルな実験ビルダー
openshot-video-editor	クロスプラットフォームのビデオエディタ
opensim	Swiftで書かれたSimPholdersのオープンソース代替
opensong	プレゼンテーションソフトウェア
opentoonz	オープンソースのフル機能の2Dアニメーション作成ソフトウェア
openttd	オープンソースの輸送シミュレーションゲーム
openvanilla	一般的な入力方法を提供します
openvisualtraceroute	OpenVisualTraceroute
openvpn-connect	OpenVPNアクセスサーバーのクライアントプログラム
openwebstart	Java11のリリース後にJavaWebStartベースのアプリケーションを実行するためのツール
openzfs	ZFSドライバーとユーティリティ
opera	ウェブブラウザ
opera-gx	ゲームを補完するOperaウェブブラウザの代替バージョン
opera-mobile-emulator	Opera Mobile Classic Emulator
opera-neon	オペラネオン
operadriver	ChromiumベースのOperaリリース用のドライバー
operator	Prelude Operatorは、デスクトップの敵対者エミュレーションプラットフォームです
opgg	ゲームの記録とチャンピオンの分析
optimage	画像最適化ツール
optimal-layout	最適なレイアウト
optimus-player	メディアプレーヤー
oracle-jdk	OracleのJDK
oracle-jdk-javadoc	OracleJDKのドキュメント
orange	コンポーネントベースのデータマイニングソフトウェア
orca	Orca
origami-studio	Facebookのデザイン、アニメーション、プロトタイプデザインツール
origin	PCゲームをプレイし、友達とつながる
orka	AppleでのKubernetesとのオーケストレーション
oryoki	薄いインターフェースを備えた実験的なWebブラウザ
osbuddy	OSBuddy
oscar	CPAP分析レポーター
oscilloscope	光線オシロスコープの美学を模倣する
osculator	MIDIコントローラーとOSCコントローラーを接続する
osirix-quicklook	OsiriXDICOMファイル用のQuickLookプラグイン
osmc	無料のオープンソースメディアセンター
osquery	SQLを利用したオペレーティングシステムのインストルメンテーションと分析
oss-browser	OSS（オブジェクトストレージサービス）用のグラフィカルな管理ツール
osxfuse	ファイルシステム統合
otto-matic	PangeaSoftwareのサイエンスフィクション3Dアクション/アドベンチャーゲーム
otx	Mach-O逆アセンブラ
outguess	Outguess
outline	アプリを取ることに注意してください
outline-manager	Shadowsocksを搭載したOutlineサーバーを作成および管理するためのツール
output-factory	AdobeInDesignからの印刷とエクスポートを自動化します
outset	outset
overdrive-media-console	地元の図書館から電子書籍、オーディオブック、ビデオを入手する
overflow	ビジュアルアプリケーションランチャー
overkill	iPhoneを接続するときにiTunesが開かないようにする
oversight	コンピューターのマイクとウェブカメラを監視します
owasp-zap	無料のオープンソースウェブアプリスキャナー
owncloud	ownCloud用のデスクトップ同期クライアント
oxygen-xml-editor	OxygenXML開発者および作成者を含むXML編集用のツール
p4	これを使用して、操作に即座にアクセスし、システムを完全に制御します
p4v	HelixCoreのビジュアルクライアント
pablodraw	PabloDraw
pacifist	パッケージファイル、ディスクイメージ、およびアーカイブからファイルとフォルダーを抽出します
packages	統合パッケージング環境
packet-peeper	ネットワークプロトコルアナライザ
packetproxy	Javaで記述されたローカルプロキシ
packetsender	TCP、UDP、SSLを送受信するためのネットワークユーティリティ
padloc	最新のパスワードマネージャー
pages-data-merge	Pagesデータマージ
pagico	すべてのタスク、ファイル、メモを管理する
paintbrush	画像エディタ
paintcode	ベクトル描画をプログラムコードに変換する
paletro	Paletro
panda	ライトモードからダークモードに切り替えるユーティリティ
pandora	PandoraWebラジオサービス用のデスクトップクライアント
panic-unison	Usenetニュースグループにアクセスするためのアプリ
panoply	netCDF、HDF、およびGRIBから地理参照データをプロットします
panwriter	Pandoc統合とページ化されたプレビューを備えたMarkdownエディター
paparazzi	Webページのスクリーンショットを撮るユーティリティ
paper	ライブ壁紙アプリ
paperpile	MicrosoftWordの引用プラグイン
papers	研究者のための参照管理ソフトウェア
paperspace	Paperspaceクラウドコンピューティングプラットフォーム用のデスクトップアプリ
papyrus	モデルベースのエンジニアリングツール
paragon-extfs	Paragon ExtFS
paragon-ntfs	Mac用ParagonNTFS
paragon-vmdk-mounter	ダブルクリックで仮想コンテナをマウントします
parallels	デスクトップ仮想化ソフトウェア
parallels-access	ParallelsAccess
parallels-client	RDPクライアント
parallels-toolbox	30以上のツールとバンドル
parallels-virtualization-sdk	デスクトップ仮想化開発キット
paraview	データ分析および視覚化アプリケーション
parse	Parse
parsec	Parsec
parsehub	ParseHub
parsify	単位と通貨の変換を備えた拡張可能な計算機
particle-dev	粒子デバイスをプログラミングするためのIDE
pashua	Pashua
password-assistant	パスワードアシスタント
password-gorilla	パスワードゴリラ
pastebot	生産性を向上させるワークフローアプリケーション
patchwork	Patchwork
path-finder	ファイルマネージャー
pathephone	分散オーディオプレーヤー
paw	APIのテストと説明に役立つHTTPクライアント
pb	プッシュ通知を取得するための非公式のPushbulletデスクトップアプリ
pcoipclient	VMエージェントおよびリモートワークステーションカード用のクライアント
pd	マルチメディア用のビジュアルプログラミング言語
pd-extended	Pd拡張
pd-l2ork	コンピュータ音楽およびマルチメディアアプリケーションのプログラミング環境
pd-runner	ParallelsDesktop用のVMランチャー
pdf-converter-master	PDFコンバーターマスター
pdf-expert	PDFリーダー、エディター、アノテーター
pdf-images	PDF-画像
pdf-over	オーストリアのBuergerkarteでPDFにデジタル署名する
pdf-reader-pro	読み取り、注釈、編集、変換、作成、OCR、フォームへの入力、PDFへの署名
pdf-squeezer	PDF圧縮ツール
pdf-toolbox	PDFツールボックス
pdfelement	PDFドキュメントの作成、編集、変換、署名
pdfelement-express	PDFelement Express
pdfextractor	PDFExtractor
pdfify	検索可能で小さいPDFを作成する
pdfkey-pro	PDFKey Pro
pdfpen	PDF編集ソフトウェア
pdfpenpro	PDF編集ソフトウェア
pdfsam-basic	ページの抽出、分割、マージ、ミキシング、PDFファイルの回転
pdfshaver	PDFファイルを縮小して小さくする
peakhour	ネットワーク帯域幅とネットワーク品質ビジュアライザー
penc	トラックパッド指向のウィンドウマネージャー
pencil	鉛筆プロジェクト
pencil2d	2D手描きアニメーションを作成するためのオープンソースツール
pennywise	Pennywise
pensela	画面注釈ツール
perforce	バージョン管理
perimeter81	サービスクライアントとしてのゼロトラストネットワーク
permute	ビデオ、オーディオ、または画像ファイルを変換および編集します
persepolis-download-manager	aria2のGUI
pester	Pester
pext	Pythonベースの拡張可能なツール
pflists	PFリスト
pg-commander	PostgreSQLクライアント
pgadmin4	PostgreSQLの管理および開発プラットフォーム
phantomjs	PhantomJS
phd2	望遠鏡ガイドソフトウェア
phew	Phew
phoenix	JavaScriptでスクリプト化可能なウィンドウとアプリマネージャー
phoenix-slides	フルスクリーンスライドショープログラム
phonegap	PhoneGap
photo-supreme-single-user	PhotoSupremeシングルユーザー
photoninja	プロフェッショナルRAWコンバーター
photosrevive	古い白黒写真を自動的に色付けする
photosweeper-x	類似または重複した写真を削除するツール
photosync	PhotoSyncコンパニオン
photozoom-pro	デジタル写真やグラフィックスを拡大および縮小するためのソフトウェア
phpstorm	JetBrainsによるPHPIDE
physics-101	物理学の分野全体にわたるシミュレーション、ツール、および方程式のコレクション
physicseditor	PhysicsEditor
pibar	メニューバーのパイホール管理
picgo	画像をアップロードするためのツール
pichon	アイコンの検索ユーティリティ8
pictogram	アプリのアイコンをカスタマイズして維持する
piezo	オーディオレコーディングアプリケーション
pika	画面上の色のカラーピッカー
pikopixel	ピクセルアートエディタ
pine	ネイティブマークダウンエディター
pineapple	Pineapple
pinegrow	Webエディター
pingid	クラウドベースの多要素認証
pingmenu	メニューバーに現在のネットワーク遅延を表示するユーティリティ
pingplotter	ネットワーク監視ツール
pinta	シンプルなGtk＃ペイントプログラム
piskel	Piskel
pitch	共同プレゼンテーションソフトウェア
pitchperfect	一分の隙もない
pivy	pivy
pixel-check	PiXelチェック
pixel-picker	画面から色を選択するためのメニューバーアプリケーション
pixelorama	Godotエンジンで作成された2Dスプライトエディタ
pixelsnap	画面測定ツール
pixelstick	画面上の距離、角度、色を測定するためのツール
pktriot	ホストサーバーアプリケーションと静的Webサイト
plain-clip	コピーしたテキストから書式を削除します
plan	Plan
plasticscm-cloud-edition	PlasticSCMをローカルにインストールし、CloudEditionサブスクリプションに参加します
platypus	コマンドラインスクリプトからネイティブアプリケーションを作成するためのツール
play	Play
playback	ビデオプレーヤー
playcover	iOSアプリとゲームをサイドロードする
playmemories-home	写真やビデオを管理および編集するフリーウェア
playonmac	Windows用に設計されたソフトウェアのインストールと使用を許可します
plex	ホームメディアプレーヤー
plex-media-player	ホームメディアプレーヤー
plex-media-server	ホームメディアサーバー
plexamp	ビジュアルに焦点を当てた音楽プレーヤー
pliim	ワンクリックでステージに上がり、輝きを放ちます！
plistedit-pro	プロパティリストとJSONエディター
plistedplus	Plistファイルエディタ
plotdigitizer	機能データのスキャンされたプロットをデジタル化する
plover	ステノタイプエンジン
plug	The HypeMachineの音楽プレーヤー
pluginval	クロスプラットフォームプラグインバリデーターおよびテスターアプリケーション
pngyu	pngquant用のフロントエンドGUIアプリケーション
pock	タッチバーにドックを表示するユーティリティ
pocket-casts	ポッドキャストプラットフォーム
podcastmenu	メニューバーに曇りを表示するツール
podolski	仮想アナログシンセサイザー
podpisuj	電子署名と署名の検証のアプリケーション
poedit	翻訳エディタ
poi	スケーラブルな艦隊これくしょんブラウザとツール
pokemon-reborn	ポケモンリボーン
pokemon-showdown	ポケモン対決
pokemon-trading-card-game-online	ポケモンTCGをオンラインでプレイ
pokerstars	無料でプレイできるオンラインポーカー
pokerth	無料のテキサスホールデムポーカー
polar-bookshelf	統合された読書環境
polkadot-js	PolkadotおよびSubstrateネットワークへのポータル
polycom-content	ポリコムコンテンツアプリ
polycom-realpresence	ビデオコラボレーションアプリ
polymail	Polymail
polypane	野心的な開発者のためのブラウザ
polyphone	Polyphone
pomatez	Pomodoroタイマー
pomello	Trelloカードをポモドーロタスクに変えます
pomodone	PomoDone
pomotodo	クリエイター向けの時間管理アプリ
pomotroid	タイマーアプリケーション
pongsaver	PongSaver
pop	リモートペアプログラミング
popchar	フォントのすべての文字を表示するユーティリティ
popclip	テキストが選択されたときにコンテキスト固有のアクションにアクセスするために使用されます
popmaker	PopMaker
popo	インスタントメッセージングプラットフォーム
popsql	PopSQL
portfolioperformance	投資ポートフォリオの全体的なパフォーマンスを計算します
porting-kit	MicrosoftWindows用にコンパイルされたゲームとアプリをインストールします
portx	SSHクライアント
post-haste	Post Haste
postbird	オープンソースのPostgreSQLGUIクライアント
postbox	プライバシー保護に焦点を当てた電子メールクライアント
posterazor	ラスターイメージスプリッター
postgres-unofficial	Postgresのアプリラッパー
postgrespreferencepane	PostgresPrefs
postico	PostgreSQLデータベース用のGUIクライアント
postman	API開発のためのコラボレーションプラットフォーム
powder	物理サンドボックスゲーム
powder-player	パウダープレーヤー
power-manager	タスクを自動化し、電力管理を改善するユーティリティ
powerpanel	UPSシステムの管理と制御
powerphotos	写真ライブラリを整理するためのツール
powershell	コマンドラインシェルとスクリプト言語
ppduck	いくつかの画像圧縮アルゴリズムを統合します
pppc-utility	PPPCペイロードを含む構成プロファイルを作成します
ppsspp	PSPエミュレーター
praat	コンピューターで音声学をする
pragli	リモートチーム用のバーチャルオフィス
pref-setter	Pref Setter
preference-manager	ビデオエディタの設定をゴミ箱、バックアップ、ロック、復元
preferencecleaner	設定ファイルを削除するタスクを簡素化するユーティリティ
preform	3D印刷のセットアップ、管理、および監視
prefs-editor	'defaults'コマンドのグラフィカルユーザーインターフェイス
prepros	Web開発コンパニオン
presentation	PDFスライド用のツール
pretzel	DMCA-クリエイターにとって安全な音楽
prey	盗難防止、データセキュリティ、および管理プラットフォーム
prezi-classic	PreziプレゼンテーションSaaS用のデスクトップクライアント
prezi-next	プレゼンテーションソフトウェア
prezi-video	ストリーミングまたは録画しながら、コンテンツをライブで操作できます
prince	HTMLをPDFに変換する
principle	アニメーション化されたインタラクティブなユーザーインターフェイスを設計する
printopia	任意のプリンターへのAirPrint
prisma-studio	Prismaプロジェクト用のビジュアルデータベースエディタ
prismatik	Prismatik
pritunl	OpenVPNクライアント
privadovpn	VPNクライアント
private-eye	Private Eye
private-internet-access	VPNクライアント
privatetunnel	VPNクライアント
privatevpn	PrivateVPN
privileges	管理者権限スイッチャー
prizmo	光学式文字認識（OCR）を使用したスキャンアプリケーション
processing	柔軟なソフトウェアスケッチブックとコーディング方法を学ぶための言語
procexp	プロセスエクスプローラー
proclaim	教会のプレゼンテーションソフトウェア
product-hunt	Product Hunt
profilecreator	標準またはカスタマイズされた構成プロファイルを作成する
profilemanager	Mozillaプロファイルマネージャー
profind	ファイル検索アプリ
programmer-dvorak	プログラマーDvorak
progressive-downloader	ダウンロードマネジャー
projectlibre	ブラウザのMicrosoftProject
projector	Swingアプリケーションをリモートで実行するための一般的なクライアント関連のコード
pronterface	PCから3Dプリンターを制御する
propresenter	ライブイベントのプレゼンテーションおよび制作アプリケーション
prosys-opc-ua-browser	OPCUAサーバーからのデータを参照して視覚化する
protege	Protect
protoio-overflow	インタラクティブなユーザーフロー図を作成する
protonmail-bridge	ProtonMailをIMAPおよびSMTPプロトコルをサポートする電子メールクライアントにブリッジします
protonvpn	セキュリティに重点を置いたVPNクライアント
protopie	インタラクティブなプロトタイプを作成する
provisioning	Provisioning
provisionql	ProvisioningQL
prowritingaid	文法チェッカー、スタイルエディター、ライティングメンター
proxifier	プロキシクライアント
proximity	Proximity
proxyman	モダンで直感的なHTTPデバッグプロキシアプリ
prudent	個人および家族の元帳のための統合環境
prusaslicer	3Dプリンター用のGコードジェネレーター（RepRap、Makerbot、Ultimakerなど）
psi	XMPPネットワーク用に設計されたインスタントメッセージングアプリケーション
psi-plus	経験豊富なユーザー向けに設計されたXMPPクライアント
psychopy	心理学および神経科学の実験を実行するため
ptpwebcam	DSLRライブビュービデオプラグイン
publii	静的ウェブサイトジェネレータ
publish-or-perish	HarzingPublishまたはPerish
pulse	ロガーとネットワークインスペクター
pulse-sms	パルスSMS用のデスクトップクライアント
puppetry	PuppeteerとJestに加えて非開発者向けのWebテストソリューション
pure-writer	Androidアプリのデスクトップバージョン
purei-play	PlayStation2エミュレーター
purevpn	PureVPN
pusher	NWPusher
pushplaylabs-sidekick	現代の仕事のために設計されたブラウザ
putio-adder	Put.IO Adder
puush	puush
puzzles	シングルプレイヤーパズルゲームを実装する小さなコンピュータプログラムのコレクション
pwnagetool	PwnageTool
pycharm	プロのPython開発のためのIDE
pycharm-ce	Pythonプログラミング用IDE-CommunityEdition
pycharm-ce-with-anaconda-plugin	Anacondaプラグインを備えたPyCharmIDE
pycharm-edu	科学およびWebPython開発のためのプロフェッショナルIDE
pycharm-with-anaconda-plugin	Anacondaプラグインを備えたPyCharmIDE
pyfa	EVEOnlineのフィッティングツール
pym-player	字幕を自動的に検索するメディアプレーヤー
pynsource	PythonソースコードをUMLにリバースエンジニアリングする
pyzo	双方向性と内省に焦点を当てたPythonIDE
qbittorrent	ピアツーピアBitorrentクライアント
qblocker	誤ってアプリを終了するのを防ぎます
qbserve	Qbserve
qcad	2Dでのコンピュータ支援製図用の無料のオープンソースアプリケーション
qcma	Qcma
qctools	QCTools
qdesktop	ウェブサイトをデスクトップの背景として設定するアプリ
qdslrdashboard	ニコン、キヤノン、ソニーのカメラを制御するためのアプリケーション
qfinder-pro	NAS管理アプリケーション
qgis	地理情報システム
qgroundcontrol	ドローン用地上管制局
qingg	五筆字型入力方式
qiyimedia	インタラクティブメディアプレーヤー
ql-ansilove	QLAnsilove
qlab	サウンド、ビデオ、照明の制御
qladdict	QLAddict
qlc-plus	DMXまたはアナログ照明システムを制御する
qlcolorcode	構文を強調表示してソースコードをレンダリングするQuickLookプラグイン
qlcommonmark	QLCommonMark
qldds	QuickLook DDS
qlfits	QLFits
qlgradle	qlgradle
qlimagesize	QuickLookで画像情報を表示し、サポートされていない形式をプレビューします
qlmarkdown	Markdownファイル用のQuickLookジェネレーター
qlmobi	QLMobi
qlnetcdf	QLNetcdf
qlplayground	qlplayground
qlprettypatch	QLPrettyPatch
qlrest	QLRest
qlstephen	QLStephen
qlswift	QLSwift
qlvideo	QuickLookビデオ
qmoji	mojibarに似ていますが、reasonmlで書かれています
qnapi	QNapi
qobuz	ストリーミングおよびダウンロード用の高解像度音楽のカタログ
qownnotes	プレーンテキストファイルのメモ帳とToDoリストマネージャー
qq	インスタントメッセージングツール
qqlive	Tencentビデオストリーミングおよび共有プラットフォーム
qqmacmgr	Tencent Computer Manager 
qqmusic	中国の音楽ストリーミングアプリケーション
qqplayer	メディアプレーヤー
qr-journal	iSight（または互換性のある）カメラを使用しているユーザーがQRコードを読み取れるようにします
qsync-client	自動ファイル同期
qsyncthingtray	Syncthingのトレイアプリ
qt-creator	アプリケーション開発のためのIDE
qt-design-studio	アプリケーション用のユーザーインターフェイス設計ツール
qt3dstudio	合成ツール
qth	APRSクライアントアプリケーション
qtox	インスタントメッセージングおよびビデオ会議アプリ
qtpass	パス用のマルチプラットフォームGUI、標準のUNIXパスワードマネージャー
qtspim	MIPS32アセンブリ言語プログラムを実行するシミュレータ
quail	非公式だが公式に受け入れられたesaアプリ
quakespasm	iDソフトウェアのQuake用エンジン
quarto	Pandoc上に構築された科学技術出版システム
quassel	IRCクライアント
quassel-client	Quassel IRC：快適にチャットできます。どこにでも
quaternion	Matrix用のIMクライアント
qudedup-extract-tool	重複排除された.qdffファイルを通常の状態に復元する
querious	MySQLおよび互換性のあるデータベースツール
querypie	データ分析チーム用のデータウェアハウスクライアント
questrade-iq-edge	Questrade IQ Edge
quickbooks	会計ソフトウェア
quickbooks-online	QuickBooks
quickboot	QuickBoot
quicken	パーソナルファイナンスマネージャー
quickgeojson	quickgeojson
quickhash	データハッシュツール
quickhue	PhilipsHue照明システムを制御するためのメニューバーユーティリティ
quickjson	QuickJSON
quicklook-csv	QuickLookCSV
quicklook-json	クイックルックJSON
quicklook-pat	Adobe Photoshop PatternsQuicklookプラグイン
quicklook-pfm	quicklook-pfm
quicklookapk	QuickLookAPK
quicklookase	QuickLookASE
quicknfo	QuickNFO
quicksilver	生産性アプリケーション
quicksync	Gigaset製品用の同期ソフトウェア
quickwords	quickワード
quik	GoProの写真とビデオにアクセスして編集する
quip	チームが生きたドキュメントを作成するためのツール
quit-all	1つ、またはすべてのアプリをすばやく終了する
quiterss	無料のニュースフィードリーダー
quitter	非アクティブな期間が経過すると、アプリを自動的に非表示または終了します
quodlibet	音楽プレーヤーおよび音楽ライブラリマネージャー
qutebrowser	PyQt5に基づくキーボード駆動のvimのようなブラウザ
qv2ray	広範なプロトコルをサポートするV2RayGUIクライアント
qview	画像ビューア
qxmledit	XMLエディター
r	統計計算とグラフィックスのための環境
r-name	R-Name
race-into-space	宇宙への競争
racket	Lisp/Schemeファミリーの最新のプログラミング言語
radar	メニューバーから重要な指標を確認する
radarr	Couchpotatoの映画で作業するSonarrのフォーク 
radiant-player	GooglePlayミュージックのアプリラッパー
radicle-upstream	コードコラボレーション用のp2pスタックであるRadicle用のデスクトップクライアント
radio-silence	ネットワークモニターとファイアウォール
raiderio	World ofWarcraftランキングサイトクライアント
raindropio	オールインワンのブックマークマネージャー
rambox	無料のオープンソースメッセージングおよび電子メールアプリ
ramme	非公式のInstagramデスクトップアプリ
rancher	デスクトップでのKubernetesとコンテナ管理
ransomwhere	個人ファイルを保護する
rapidminer-studio	データサイエンスプラットフォーム
rapidweaver	Webデザインソフトウェア
rar	データ圧縮とバックアップのためのアーカイブマネージャー
raspberry-pi-imager	microSDカードにオペレーティングシステムをインストールするためのイメージングユーティリティ
raven-reader	柔軟な設定のニュースリーダー
raw-photo-processor	生の写真を処理する
rawtherapee	RAWフォトプロセッサー
ray	Rayを使用してデバッグし、問題をより迅速に修正します
raycast	数回のキーストロークでツールを制御します
raze	GZDoomtechに裏打ちされたエンジンポートを構築する
razorsql	RazorSQL
rclone-browser	Rcloneブラウザ
react-native-debugger	ReactNativeアプリをデバッグするためのスタンドアロンアプリ
react-proto	開発者と設計者のためのReactアプリケーションプロトタイピングツール
react-studio	ReactStudio
reactotron	ReactJSおよびReactNativeプロジェクトを検査するためのデスクトップアプリ
realforce	Realforceキーボードおよびマウス用のソフトウェア
reamp	SwiftUIで記述されたWinAMPクローン
reaper	デジタルオーディオ制作アプリケーション
recaf	Javaバイトコードエディタ
receiptquicklook	ReceiptQuickLook
receipts	Receipts
recents	ファイルランチャー
recordit	スクリーンキャストソフトウェア
recovery-disk-assistant	リカバリディスクアシスタント
rectangle	キーボードショートカットまたはスナップ領域を使用してウィンドウを移動およびサイズ変更
rectangle-pro	ウィンドウスナップツール
recut	ビデオから無音を削除し、カットリストを自動的に生成します
red	レッドプログラミング言語
red-eye	Red Eye
redcine-x-pro	REDCODERAWフッテージをトランスコードして操作する
redeclipse	Red Eclipse
redis-pro	Redisデスクトップ
redisinsight	合理化されたRedisアプリケーション開発のためのGUI
redream	ドリームキャストエミュレータ
reflector	ワイヤレス画面ミラーリングアプリケーション
regexhibit	Perl正規表現アシスタント
reggy	インタラクティブな正規表現バリデーターおよびテスター
reikey	キーボードタップをスキャン、検出、および監視します
rekordbox	あなたの音楽ファイルを準備して管理するための無料のDjアプリ
remarkable	ファイルの表示、画面共有、整理、インポート、およびreMarkableデバイスへのダウンロード
rember	レンバー
remember-the-milk	やることアプリ
remix-ide	イーサリアムのスマートコントラクト開発に使用されるデスクトップバージョンのRemixWeb IDE
remnote	間隔反復を利用したメモ取りツール
remote-buddy	Remote Buddy
remote-desktop-manager	すべてのリモート接続を単一のプラットフォームに一元化します
remote-desktop-manager-free	すべてのリモート接続を単一のプラットフォームに一元化します
remote-wake-up	ボタンをクリックするだけでデバイスをウェイクアップ
remotehamradio	RemoteHamRadioサービス用のデスクトップコンソールアプリ
remoteviewer	Remote Viewer
remotion	リモートチーム向けのコミュニケーションツール
remotix-agent	リモートデスクトップおよび監視ソリューション
removebg	自動バルクバックグラウンド除去
renamer	バッチファイルリネームアプリケーション
renpy	Pythonのビジュアルノベルエンジン
repetier-host	3Dプリントアプリケーション
replacicon	アプリアイコン置換ユーティリティ
repoz	Zero-confgitリポジトリハブ
rescuetime	時間最適化アプリケーション
resilio-sync	ファイル同期および共有ソフトウェア
resolume-arena	ビデオマッピングソフトウェア
resolutionator	ディスプレイで利用可能な解像度のいずれかを使用します
responsively	レスポンシブウェブ開発に役立つ変更されたブラウザ
restream-chat	ストリーミングチャットを1か所に保管する
retinizer	Retinizer
retro-virtual-machine	ZXSpectrumおよびAmstradCPCエミュレーター
retroactive	互換性のないOSバージョンでAppleアプリを実行する
retroarch	エミュレータフロントエンド（OpenGLグラフィックAPIバージョン）
retroarch-metal	エミュレータフロントエンド（Metal Graphics APIバージョン）
retrobatch	バッチ画像プロセッサ
retroshare	Friend-2-Friendと安全な分散型通信プラットフォーム
reunion	系図（家系図）アプリ
reveal	iOS開発者向けの強力なランタイムビューデバッグ
revolver-office	プロジェクト管理ツール
rhino	3Dモデルクリエーター
ricochet	匿名のピアツーピアインスタントメッセージング
ricochet-refresh	Torを介したプライベートおよび匿名のインスタントメッセージング
rider	.NET IDE
ridibooks	Ridibooks
rightfont	フォントのプレビュー、インストール、同期、管理を支援するフォントマネージャー
rightzoom	フルスクリーンボタンの動作を変更します
ringcentral	チームメッセージング、ビデオ会議、およびビジネス電話
ringcentral-classic	RingCentralクラシック
ringcentral-meetings	ビデオ会議、画面共有、およびチームメッセージングプラットフォーム
ringcentral-phone	電話システムマネージャー
ripcord	Slack（およびDiscord）用のデスクトップチャットクライアント
ripme	さまざまなウェブサイトのアルバムリッパー
roaringapps	RoaringApps
robo-3t	MongoDB管理ツール
robofont	フォントエディタ
roboform	パスワードマネージャーとフォームフィラーアプリケーション
rocket	目の不自由な人向けに最適化された絵文字ピッカー
rocket-chat	Rocket.Chatの公式デスクトップクライアント
rocket-typist	ロケットタイピスト
rocks-n-diamonds	アーケードスタイルのゲーム
rodeo	Python用データサイエンスIDE
roku-remote-tool	Rokuリモートツール
rolisteam	仮想卓上ソフトウェア
roon	音楽プレーヤー
rosaimagewriter	ROSA ImageWriter
rotato	モックアップジェネレーターとアニメーター3D
rotki	ポートフォリオ追跡および会計ツール
routebuddy	GPS対応のマッピングソフトウェア
routeconverter	ルート、トラック、ウェイポイントを表示、編集、強化、変換するためのGPSツール
rowanj-gitx	gitバージョン管理システム用のネイティブグラフィカルクライアント
rowmote-helper	RowmoteProリモートコントロールを備えた制御システム
royal-tsx	リモート管理ソリューション
rpn-scientific	RPN関数電卓
rq	rq
rrcc	ロボロックコントロールセンター
rssowl	RSSOwl
rstudio	RとPythonに焦点を当てたデータサイエンスソフトウェア
rsyncosx	rsyncのGUI
rubymine	Ruby on Rails IDE
rubymotion	RubyMotion
runelite	Old SchoolRuneScapeのクライアント
runescape	RuneScape
runjs	コードが入力されると自動評価されるJavaScriptプレイグラウンド
runway	機械学習を活用したクリエイティブツールキット
ryver	Ryver
sabaki	囲碁とSGFエディター
sabnzbd	バイナリニュースリーダー
safe-exam-browser	電子評価を安全に実施するためのWebブラウザ環境
safe-multisig	イーサリアムマルチシグウォレット
safeincloud-password-manager	SafeInCloudパスワードマネージャー
sage	数学ソフトウェアシステム
sameboy	Cで書かれたゲームボーイとゲームボーイカラーエミュレーター
samsung-dex	一部のSamsungデバイスをデスクトップのようなエクスペリエンスに拡張します
santa	バイナリ認証システム
saoimageds9	SAOImage DS9
sapmachine-jdk	SAPからのOpenJDKディストリビューション
satellite-eyes	サテライトアイズ
sauce-connect	SauceLabs自動テストプラットフォームに安全に接続するためのプロキシサーバー
sauerbraten	マルチプレイヤー＆シングルプレイヤー一人称シューティングゲーム
save-hollywood	カスタムビデオファイルのスクリーンセーバー
scala-ide	Scala IDE
scansion	scansion
scap-workbench	SCAPスキャナーとグラフィカルユーザーインターフェイスの調整
scapple	メモ帳ソフトウェア
scatter	EOS用デスクトップウォレット
scenebuilder	JavaFX用のGUIデザイナをドラッグアンドドロップします
schildichat	より伝統的なIMエクスペリエンスを備えたElementに基づくMatrixクライアント
schism-tracker	オールドスクールのサンプルベースの作曲ツール
scidavis	科学データの分析と視覚化への応用
scidvsmac	チェスツールキット
scihubeva	Sci-HubGUIアプリ
scilab	数値計算用ソフトウェア
scout	シンプルなSassプロセッサ
scrapp	クラウドストレージを備えたスクリーンショットツール
scratch	インタラクティブなストーリー、ゲーム、アニメーションをプログラムします
screaming-frog-seo-spider	SEOサイト監査ツール
screencast	シンプルなスクリーンビデオキャプチャアプリケーション
screenflick	オーディオ付きスクリーンレコーダー
screenflow	画面録画およびビデオ編集ソフトウェア
screenfocus	複数の画面を管理するためのツール
screens	使いやすさに焦点を当てたリモートアクセスソフトウェア
screens-connect	リモートデスクトップソフトウェア
scribus	無料のオープンソースページレイアウトプログラム
script-debugger	AppleScriptに完全に焦点を合わせた統合開発環境
scriptql	AppleScript QuickLookプラグイン
scrivener	タイプライタースタイルのワードプロセッシングソフトウェア
scroll	トラックパッドとマジックマウスでスクロールを設定する
scroll-reverser	スクロール方向を逆にするツール
scummvm	古典的なグラフィカルアドベンチャーとロールプレイングゲームを実行する
sdformatter	SDファイルシステム仕様に準拠したメモリーカードをフォーマットするツール
sdm	Strongdmクライアント
sdrdx	SdrDx
seadrive	Seafileサーバーのマニュアル
seafile-client	ファイル同期クライアント
seaglass	マトリックスクライアント
seamonkey	SeaMonkeyインターネットアプリケーションスイートの開発
seashore	GIMPに似た画像編集アプリケーション
second-life-viewer	SecondLifeオンライン仮想世界向けの3Dブラウジングソフトウェア
secretive	SSHキーをセキュアエンクレーブに保存する
secure-pipes	SSHトンネルを管理する
securesafe	パスワードマネージャーによる安全性の高いオンラインストレージ
securid	認証ソフトウェア
security-growler	セキュリティグローラー
securityspy	SecuritySpy
segger-embedded-studio-for-arm	組み込みシステム向けIDE
sejda-pdf	PDFエディター
sekey	SeKey
selfcontrol	気が散るWebサイトへの自分のアクセスをブロックする
semeru-jdk-open	OpenJDKクラスライブラリとEclipseOpenJ9JVMを備えた本番環境対応のJDK
semulov	メニューバーからマウントされたボリュームとマウントされていないボリュームにアクセスします
sencha	煎茶コマンド
send-anywhere	ファイル共有アプリ
send-to-kindle	MacからKindleに個人文書を送信するためのツール
sengi	マストドンとプレローマのデスクトップクライアント
sensei	コンピュータシステムを監視し、そのパフォーマンスを最適化します
sensiblesidebuttons	賢明なサイドボタン
sentinel	コードとしてのポリシーの言語とフレームワーク
senuti	曲、プレイリスト、またはビデオをiPodからコンピュータに転送します
sequel-ace	MySQL / MariaDBデータベース管理
sequel-pro	MySQL / MariaDBデータベース管理プラットフォーム
sequential	画像とPDFファイルのフォルダとアーカイブを表示します
serial	シリアルポートでほとんど何にでも接続できます
serial-tools	シリアルツール
serviio	メディアサーバー
servo	Servo
servpane	メニューバーアプリを起動
session	オニオンルーティングベースのメッセンジャー
session-manager-plugin	管理対象インスタンスに接続するセッションを開始および終了するAWSCLIのプラグイン
sessionrestore	後で読むために多数のSafariタブを開いたままにしておくのに役立ちます
setapp	サブスクリプションで利用可能なアプリのコレクション
sf-symbols	アプリに一貫性のある高度に構成可能なシンボルを提供するツール
sfdx	Salesforce DX CLI
shades	シェード
shadow	クラウドテクノロジーを搭載したゲーミングPC
shadowsocksx	規制に従って削除
shadowsocksx-ng	ShadowsocksX-NG
shadowsocksx-ng-r	次世代のShadowsocksX
shapes	ダイアグラム作成アプリ
shapr3d	3DCADソフトウェア
sharemouse	コンピュータ間で周辺機器を共有する
sharepod	Sharepod
shearwater-cloud	ダイビングログデータの確認、編集、共有
shellhere	ターミナルで現在地を開くFinder用ツールバーアプリ
sherlock	Sherlock
shiba	リンター付きのリッチマークダウンライブプレビューアプリ
shield	プロセス注入から保護するアプリ
shift	アカウント、アプリ、ワークフローを合理化するワークステーション
shiftit	ウィンドウのサイズと位置を管理するためのツール
shifty	ナイトシフトをより細かく制御できるメニューバーアプリ
shimeike-formulatepro	PDFドキュメントにテキストとグラフィックをオーバーレイします
shimo	安全なインターネットアクセスとプライベートブラウジングのためのVPNクライアント
shimonote	ドキュメントエディタ
shiori	しおり
shortcat	スプラウトキューブショートキャット
shortcutdetective	どのアプリがキーボードショートカット（ホットキー）を受信するかを検出します
shortcutor	iOSショートカットエディタ
shortcuts	再起動/スリープ/ログアウト/シャットダウン/ロックショートカット
shortery	ショートカットの自動化
shotcut	動画編集者
shottr	スクリーンショット測定および注釈ツール
showhiddenfiles	ShowHiddenFiles
showyedge	現在の入力ソースの可視インジケータ
shrinkit	ShrinkIt
shupapan	Shupapan
shutter-encoder	ビデオ、オーディオ、画像コンバーター
shuttle	シンプルなショートカットメニュー
sia-ui	Siaのグラフィカルフロントエンド
sidekick	Sidekick
sidenotes	メモを取るアプリケーション
sidequest	バーチャルリアリティコンテンツプラットフォーム
sidestep	Sidestep
sigdigger	SigDigger
sigil	EPUB電子ブックエディタ
sigmaos	ウェブブラウザ
signal	セキュリティに焦点を当てたインスタントメッセージングアプリケーション
signet	バンドル署名をスキャンしてチェックします
silentknight	コンピュータのセキュリティを自動的にチェックします
silicon	Intelのみのアプリを特定する
silicon-info	実行中のアプリケーションのアーキテクチャを表示する
silnite	EFIファームウェアとセキュリティデータファイルの更新を確認します
silo	3DポリゴンモデラーとUVマッパー
sim-daltonism	ビデオと画像の色覚異常シミュレータ
sim-genie	Sim Genie
simpholders	SimPholders
simple-comic	コミックビューア/リーダー
simplediagrams	SimpleDiagrams
simplefloatingclock	シンプルなフローティングクロック
simplelink-msp432-sdk	MSP432P4マイクロコントローラー用のソフトウェア開発キット
simplenote	SimplenoteのReactクライアント
simplesynth	SimpleSynth
simplistic	jlutil
simply-fortran	Fortran開発環境
simsim	ターミナルまたはファインダーでiOSアプリケーションフォルダーを探索するためのツール
simtoolkitpro	シミュレーター用のEFBソフトウェア
singularity	SecondLifeとOpenSimのクライアント
sioyek	研究論文や技術書を読むために設計されたPDFビューア
sip	色を収集、整理、共有する
sipgate-softphone	コンピューターで電話をかける
sirimote	Apple TV SiriRemoteでコンピュータを制御する
sitala	ドラムサンプラープラグインとスタンドアロンアプリ
sitebulb	ウェブサイト監査ツール
sitesucker-pro	ウェブサイトダウンローダーツール
sixtyforce	N64エミュレーター
siyuan	ローカルファーストのパーソナルナレッジマネジメントシステム
sizeup	アプリケーションウィンドウのサイズ変更と配置を行うユーティリティ
sizzy	複数のデバイスでレスポンシブデザインをシミュレートするツール
skala-preview	Skalaプレビュー
sketch	デジタルデザインおよびプロトタイピングプラットフォーム
sketch-toolbox	スケッチツールボックス
sketchbook	描画、ペイント、スケッチアプリケーション
sketchpacks	スケッチパック
sketchup	3D設計ソフトウェア
sketchup-pro	3D視覚化ソフトウェア
skim	PDFリーダーとメモ取りアプリケーション
skitch	マークアップと共有機能を備えた画面キャプチャツール
sky-ticket	スカイチケットコンテンツのストリーミング
skychart	星図を描く
skyfonts	フォントマネージャー
skype	ビデオチャット、音声通話、インスタントメッセージングアプリケーション
skype-for-business	Microsoftのインスタントメッセージングエンタープライズソフトウェア
skypewebplugin	SkypeWebプラグイン
slack	チームコミュニケーションおよびコラボレーションソフトウェア
slate	ウィンドウ管理アプリケーション
sleek	todo.txtに基づくTodoアプリ
sleipnir	Sleipnir
slic3r	Slic3r
slicer	医用画像処理および視覚化システム
slidepilot	PDFプレゼンテーションツール
slik	Slik
slimbatterymonitor	SlimBatteryMonitor
slimhud	音量、明るさ、キーボードのバックライトHUDの交換
slingplayer	Sling製品のデスクトップアプリケーション
slippi-dolphin	Slippiを介したネットプレイをサポートするDolphinGameCubeとWiiエミュレーターのフォーク
slite	チームコミュニケーションおよびコラボレーションソフトウェア
sloth	実行中のすべてのプロセスで使用されているすべての開いているファイルとソケットを表示します
smart-converter-pro	ビデオコンバーター
smartgit	Gitクライアント
smartreporter-free	ドライブ障害監視ツール
smartsvn	Subversionクライアント
smartsynchronize	ファイルとディレクトリの比較ツール
smcfancontrol	内蔵ファンの最低速度を設定します
smlnj	Standard ML'97プログラミング言語用のコンパイラ
smoothscroll	スムーズなマウススクロールユーティリティ
smooze	スクロールホイールマウスを再発見する
smplayer	コーデックが組み込まれたメディアプレーヤー
smultron	汎用テキストエディタ
snagit	スクリーンキャプチャソフトウェア
snapmotion	ビデオから画像を抽出する
snapndrag	スクリーンキャプチャアプリケーション
snappy	Snappy
sneek	スネーク
snes9x	Snes9x
snip	Snip
snipaste	スクリーンショットを切り取るかピン留めする
snipy	共有サポート付きのスニペットマネージャー
snowflake-snowsql	Snowflakeに接続するためのコマンドラインクライアント
snwe	拡張可能でカスタマイズ可能なメニューバーの交換
soapui	APIテストツール
socket-io-tester	socket-io-tester.app
sococo	Sococo
soda-player	ビデオプレーヤーとストリーミングプラットフォーム
soduto	デバイス間で情報を通信および共有する
sofa-server	Sofa
softmaker-freeoffice	オフィススイート
softorino-youtube-converter	YouTubeダウンローダーとコンバーター
softraid	強力で直感的なソフトウェアRAIDユーティリティ
softube-central	Softube製品のインストールとライセンスアクティベーション用のインストーラー
sogouinput	フルスペルとダブルスペルをサポートする入力方式
solar2d	Luaベースのゲームエンジン
solvespace	パラメトリック2d / 3d CAD
sonarr	UsenetおよびBitTorrentユーザー向けのPVR
sonarr-menu	Sonarrを管理するためのメニューをステータスバーに追加するユーティリティ
sonic-lineup	比較のための複数のオーディオファイルの迅速な視覚化
sonic-pi	コードベースの音楽作成およびパフォーマンスツール
sonic-robo-blast-2	DoomのDoomLegacyポートを使用して構築された3DオープンソースSonictheHedgehogファンゲーム
sonic-robo-blast-2-kart	クラシックなスタイルのカートレーサー、美しいコースと奇抜なアイテムを完備
sonic-visualiser	音楽オーディオ録音の視覚化、分析、および注釈
sonic3air	ソニック3＆ナックルズの再実装（オリジナルゲームが必要）
sonoair	SonoAir
sonobus	高品質のネットワークオーディオストリーミング
soothe2	動的共振サプレッサー
soqlxplorer	Salesforce.comプラットフォーム用のデスクトップクライアント
soulseek	ファイル共有ネットワーク
soulver	電卓内蔵のメモ帳
sound-control	アプリごとのオーディオコントロール
sound-siphon	アプリのオーディオキャプチャ
soundboosterlite	強化されたオーディオ体験のためのアプリ
soundcleod	SoundCleod
soundcloud-downloader	曲をsoundcloudからコンピューターにダウンロードする
soundflower	サウンドフラワー
soundflowerbed	Soundflowerチャネルを利用して、オーディオデバイスにルーティングします
soundsource	サウンドおよびオーディオコントローラー
soundtoys	オーディオエフェクトプラグイン
sourcenote	SourceNote
sourcetrail	コードソースエクスプローラー
sourcetree	Gitバージョン管理用のグラフィカルクライアント
space-saver	ローカルのTimeMachineバックアップを削除する
spaceid	現在選択されているスペースを示すメニューバーインジケーター
spacelauncher	SpaceLauncher
spaceman	メニューバーにスペース/仮想デスクトップを表示
spaceradar	Electronとd3.jsで構築されたディスクとメモリ空間の視覚化アプリ
spamsieve	電子メールクライアント用のスパムフィルタリング拡張機能
spark	Spark
spark-ar-studio	Facebookファミリーのアプリを使用して、拡張現実体験を作成および共有します
sparkle	Cocoa開発者向けのソフトウェア更新フレームワーク
sparkleshare	Gitリポジトリと即座に同期するツール
sparrow	ビットコインウォレットアプリケーション
spatial	ImprobableSpatialOSプラットフォームとの相互作用のためのバイナリ
spatterlight	ほとんどの種類のインタラクティブフィクションゲームファイルを再生する
spechtlite	ルールベースのプロキシ
spectacle	ウィンドウの移動とサイズ変更が簡単
spectacle-editor	Spectacleエディタをドラッグアンドドロップします
specter	ハードウェアウォレットで動作するように最適化されたビットコインコアのデスクトップGUI
speedcrunch	SpeedCrunch
speedify	VPNクライアント
spideroakone	クラウドのバックアップとストレージ
spillo	Spillo
spires	inspire-hepとarxivのフロントエンド
spitfire-audio	Spitfireオーディオライブラリのダウンロードマネージャー
splashtop-business	リモートアクセスソフトウェア
splashtop-personal	デスクトップおよびモバイルデバイスからコンピューターに接続して制御する
splashtop-streamer	デスクトップおよびモバイルデバイスからコンピューターに接続して制御する
splayer	メディアプレーヤー
splice	クラウドベースの音楽作成およびコラボレーションプラットフォーム
splitshow	SplitShow
spotifree	Spotifyの広告を自動的にミュートします（サポートされていません）
spotify	音楽ストリーミングサービス
spotify-now-playing	Spotify-再生中
spotmenu	メニューバーのSpotifyとiTunes
spotspot	Spotifyミニプレーヤー
spotter	すべてを立ち上げる生産性ツール
springtoolsuite	SpringBoot用の次世代ツール
spyder	科学的なPythonIDE
sql-tabs	SQLタブ
sqlcl	Oracle SQLclは、Oracleデータベースの最新のコマンドラインインターフェイスです。
sqlectron	Sqlectron
sqleditor	SQLデータベース設計ツール
sqlexplorer	Eclipse SQL Explorer
sqlight	データベース管理ツール
sqlitemanager	sqliteデータベースのデータベース管理システム
sqlitestudio	SQLiteデータベースの作成、編集、閲覧
sqlpro-for-mssql	Microsoft SQLServerデータベースクライアント
sqlpro-for-mysql	MySQL＆MariaDBデータベースクライアント
sqlpro-for-postgres	軽量のPostgresSQLデータベースクライアント
sqlpro-for-sqlite	高度なsqliteエディター
sqlpro-studio	データベース管理ツール
sqlworkbenchj	DBMSに依存しないSQLクエリツール
squeak	Squeak
squidman	SquidMan
squirrel	ライム入力方式エンジン
squirrelsql	JDBC準拠のデータベースの構造を表示するためのグラフィカルJavaプログラム
srware-iron	SRWare SRWare Iron
ssdreporter-free	SSDヘルスモニタリングツール
ssh-config-editor	OpenSSHsshクライアント構成ファイルを管理するためのツール
ssh-tunnel-manager	SSHトンネルマネージャー
ssokit	TCPおよびUDPデバッグツール
stack	ファイルを保存、表示、共有するための個人用オンラインハードドライブ
stack-exchange-notifier	Stack ExchangeNotifier
stack-stack	すべての生産性アプリを1か所から管理するためのワークスペース
stand	1時間に1回立ち上がるように通知します
standard-notes	無料のオープンソースの完全に暗号化されたメモアプリ
starcraft	Starcraft
starleaf	Starleaf
starsector	オープンワールドのシングルプレイヤー宇宙戦闘およびトレーディングRPG
start	Tencentクラウドゲームプラットフォーム
startninja	StartNinja
startupizer	ログインアイテムハンドラ
staruml	ソフトウェアモデラー
stationtv-link	StationTV ﾂ✓リンク
stats	メニューバーのシステムモニター
statusfy	ステータスバーでSpotify
stay	Windowsマネージャー
steam	ビデオゲームデジタル配信サービス
steam-plus-plus	Steamヘルパーツール
steamcmd	SteamCMD
steermouse	マウスボタン、ホイール、カーソル速度をカスタマイズする
stella	マルチプラットフォームのAtari2600エミュレーター
stellarium	画面上にリアルタイムでリアルな空をレンダリングするツール
stems	オーディオファイルを個々のトラックに分割する
stepmania	家庭用とアーケード用の両方で使用できるように設計された高度なリズムゲーム
steveschow-gfxcardstatus	gfxCardStatus
stoplight-studio	APIを設計および文書化するためのエディター
stork	ハイブリッド作業のための強力な機能を備えたメッセンジャー
storyboarder	棒人間を描くことができるのと同じくらい速く物語を視覚化する
strawberry	音楽プレーヤーと音楽コレクションの主催者
strawberry-wallpaper	イチゴの壁紙
streamlabs-obs	オールインワンのライブストリーミングソフトウェア
streamlink-twitch-gui	Streamlink用のマルチプラットフォームTwitch.tvブラウザ
stremio	オープンソースメディアセンター
stretchly	休憩時間リマインダーアプリ
stringsfile	StringsFileQuickLookプラグイン
stringz	ローカライズ可能なファイルのエディター
strongvpn	StrongVPN
stubbymanager	StubbyManager
studio-3t	MongoDBのIDE、クライアント、およびGUI
studiolinkstandalone	高品質のAudioover IP（AoIP）接続を作成するためのSIPアプリケーション
subethaedit	プレーンテキストとソースエディタ
subgit	SVNリポジトリをGitに変換する
subler	マルチプレクサとタグのmp4ファイル
sublercli	Sublerのコマンドラインバージョン
sublime-merge	Gitクライアント
sublime-text	コード、マークアップ、散文用のテキストエディタ
subnetcalc	IPサブネットを計算するためのツール
subsurface	オープンソースのダイブログプログラム
subsync	字幕音声シンクロナイザー
subtitle-master	字幕マスター
subtitles	字幕映画やテレビ番組を自動的にダウンロードします
subtools	ヘルパー-MP4tools、MKVtools、およびAVItoolsのアプリケーション
suitcase-fusion	フォントマネージャー
sunloginclient	リモートデスクトップ制御および監視ツール
sunlogincontrol	リモートデスクトップ制御および監視ツールのターゲットコンポーネント
sunsama	Sunsama
sunvox	モジュラーシンセサイザー
supercollider	サウンド合成とアルゴリズム作曲のためのサーバー、言語、IDE
superduper	バックアップ、リカバリ、クローン作成ソフトウェア
superhuman	メールクライアント
supermjograph	データから科学的なグラフを生成する
superproductivity	やることリストとタイムトラッカー
superslicer	3DモデルをGコード命令またはPNGレイヤーに変換します
supersync	SuperSync
supertuxkart	カートレーシングゲーム
surfeasy-vpn	SurfEasy VPN
surfshark	安全なインターネットアクセスとプライベートブラウジングのためのVPNクライアント
surge	ネットワークツールボックス
surge-synthesizer	ハイブリッドシンセサイザー
surge-xt	ハイブリッドシンセサイザー
suspicious-package	インストーラーパッケージを検査するためのアプリケーション
suuntodm5	ダイビングプランを作成し、ダイビングを分析します
svgcleaner	不要なデータを削除してSVGファイルをクリーンアップするツール
svnx	svnX
sweet-home3d	インテリアデザインアプリケーション
swift	SwiftXMPPクライアント
swift-publisher	ページレイアウトとデスクトップパブリッシングアプリケーション
swiftbar	メニューバーカスタマイズツール
swiftdefaultappsprefpane	Swiftで書かれたRCDefaultAppsの代替品
swiftformat-for-xcode	Swiftコードを再フォーマットするためのXcode拡張
swiftplantumlapp	XcodeでSwiftコードのクラス図を生成して表示します
swiftpm-catalog	Swift PackageManagerパッケージを参照して検索する
swiftstack-client	SwiftStackデータストレージおよび管理プラットフォームにアクセスする
swifty	オフラインパスワードマネージャーツール
swiftybeaver	SwiftyBeaver
swimat	Swiftコード用のXcodeフォーマッタープラグイン
swinsian	音楽プレーヤー
swish	トラックパッドから直接ウィンドウとアプリケーションを制御する
switch	マルチフォーマットオーディオファイルコンバータ
switchhosts	ホストを切り替えるアプリ
switchkey	SwitchKey
switchresx	画面表示設定を制御します
symboliclinker	ユーザーがFinderでシンボリックリンクを作成できるようにするサービス
synalyze-it-pro	16進編集およびバイナリファイル分析アプリ
sync	どこからでもファイルを保存、共有、アクセスできます
sync-my-l2p	L2PとRWTHアーヘンのMoodleからのドキュメントを同期します
syncalicious	複数のマシン間で設定をバックアップおよび同期する
syncmate	オールインワン同期ツール
syncovery	ファイル同期およびバックアップソフトウェア
syncplay	メディアプレーヤーを同期します
syncroom	オンラインリモートコンサートサービス：遠く離れていても演奏を楽しむ
syncsettings	アプリの設定を同期して保存する
syncterm	BBSターミナルプログラム
syncthing	リアルタイムファイル同期ソフトウェア
synergy	キーボードとマウスの共有ツール-オープンソースコア
synfigstudio	2Dアニメーションソフトウェア
synology-chat	SynologyNASで実行されるメッセージングサービス
synology-note-station-client	コンテンツが豊富なメモを作成、表示、管理、共有する
syntax-highlight	ソースファイルのQuicklook拡張機能
synthesia	落下音を使ってピアノを弾く方法を学ぶ
sysdig-inspect	Sysdig Inspect
sysex-librarian	SysExライブラリアン
tabby	ターミナルエミュレータ、SSH、シリアルクライアント
table-tool	CSVファイルエディタ
tableau	データ視覚化ソフトウェア
tableau-prep	分析のためにデータを結合、形成、およびクリーンアップします
tableau-public	データの視覚化をオンラインで探索、作成、公開共有
tableau-reader	TableauDesktopに組み込まれているデータの視覚化を開いて操作します
tablecruncher	軽量CSVエディター
tableflip	マークダウンファイルを編集するアプリ
tableplus	リレーショナルデータベース用のネイティブGUIツール
tabtopus	WebブラウザタブURLエクスポータ
tabula	PDFファイル内に閉じ込められたデータテーブルを解放するためのツール
tad	表形式のデータを表示および分析するためのデスクトップアプリケーション
tag	音楽タグエディタ
tagger	バッチ編集とVGMdbデータのインポートをサポートする音楽メタデータエディタ
tagspaces	タグ付けをサポートするオフラインのオープンソースのドキュメントマネージャー
tales-of-majeyal	トップダウン戦術RPGローグライクゲームとゲームエンジン
talon	音声、視線追跡、またはノイズでコンピュータを制御できます
tandem	リモートチーム用のバーチャルオフィス
tap-forms	重要なファイルを1か所に整理するのに役立ちます
taskade	チームのタスクマネージャー
taskexplorer	実行中のすべてのタスク（プロセス）を探索するためのツール
taskpaper	リストを作成し、整理を支援するアプリ
taskwarrior-pomodoro	Taskwarrior-ポモドーロ
tastyworks	tastyworks証券会社向けのデスクトップ取引プラットフォーム
tau	TAU
td-agent	Fluentd配布パッケージ
teacode	開発者向けのテキスト拡張アプリ
teambition	Teambition
teamdrive	安全なクラウドストレージサービス
teamspeak-client	音声通信クライアント
teamviewer	セキュリティに重点を置いたリモートアクセスおよび接続ソフトウェア
teamviewer-host	TeamViewerホスト
teamviewer-quickjoin	TeamViewer QJ
teamviewer-quicksupport	TeamViewer QS
teamviewermeeting	ビデオ会議および通信ソフトウェア
techsmith-capture	スクリーンキャプチャソフトウェア
teensy	Teensy
teeworlds	Teeworlds
telegram	速度とセキュリティに重点を置いたメッセージングアプリ
telegram-desktop	Telegramメッセンジャー用のデスクトップクライアント
tempo	すべての電子メールをバッチで配信する電子メールクライアント
temurin	Eclipse Foundation（Adoptium）のJDK
tenable-nessus-agent	Nessus脆弱性スキャナーのエージェント
tencent-docs	Word、Excel、PPTドキュメント用のオンラインエディタ
tencent-lemon	クリーンアップおよびシステムステータスツール
tencent-meeting	クラウドビデオ会議
tenor	メニューバーからgifを送信、共有、保存する
tentacle-sync-studio	タイムコードを介してビデオとオーディオを自動的に同期します
termhere	現在のディレクトリから端末を開くためのFinder拡張機能
terminology	terminology
termius	SSHクライアント
tetrio	無料でプレイできるテトリスクローン
tev	OpenEXR画像に重点を置いたHDR画像比較ツール
tex-live-utility	TeX LiveManagerのグラフィカルユーザーインターフェイス
texmacs	科学編集プラットフォーム
texmaker	LaTeXエディター
texpad	LaTeXエディター
texshop	TeXプレビューア
texstudio	LaTeXエディター
textadept	テキストエディタ
textbar	メニューバーにテキストを追加する
textbuddy	テキストの変換、フィルタリング、並べ替え、変換
textexpander	作成済みのテキストスニペットを任意の場所に挿入します
textmate	汎用テキストエディタ
texts	プレーンテキストのマークダウンを使用するワードプロセッサ
textsniper	画像やその他のデジタルドキュメントから数秒でテキストを抽出します
textual	インターネットリレーチャット（IRC）チャットルームと対話するためのアプリケーション
texturepacker	ゲームスプライトシートパッカー
texworks	メインコードベース
tg-pro	温度監視、ファン制御および診断
th-makerx	Th-MakerX
the-archive	メモを取る：Nimble、Calm、Plain.txt
the-archive-browser	アーカイブの内容を閲覧する
the-battle-for-wesnoth	ファンタジーをテーマにしたターン制ストラテジーゲーム
the-cheat	ゲームトレーナー
the-clock	時計とタイムゾーンのアプリ
the-tagger	落書き犯
the-unarchiver	アーカイブファイルを解凍します
the-unofficial-homestuck-collection	ウェブコミックHomestuckのオフラインビューア
the-watcher	ETHウォレット、USD-ETH価格、ガス価格を監視する
thebrain	マインドマッピングと個人知識ベースソフトウェア
thedesk	PC用のマストドン/ミスキークライアント
themeengine	コンパイルされた.carファイルを編集するアプリ
there	チーム内の人々の現地時間を表示するツール
therm	優れたデフォルトと最小限の機能を持つことを目的としたiTerm2のフォーク
thetimemachinemechanic	TimeMachineログビューアとステータスインスペクタ
thingsmacsandboxhelper	モノのヘルパーアプリケーション
thinkorswim	thinkDesktop
thonny	初心者のためのPythonIDE
thonny-xxl	初心者のためのPythonIDE
thor	アプリケーションを切り替えるユーティリティ
thorium	Epubリーダー
thought-train	メモ取りとやることリストの申請
threads	集中的な議論と意思決定のためのコミュニケーションツール
threema	エンドツーエンドの暗号化されたインスタントメッセージングアプリケーション
threema-work	エンドツーエンドの暗号化されたインスタントメッセージングアプリケーション
thumbsup	ThumbsUp
thunder	VPNおよびWiFiプロキシ
thunderbird	カスタマイズ可能なメールクライアント
thyme	タスクタイマー
ti-connect-ce	グラフ電卓のTI-84Plusファミリ用の接続ソフトウェア
tibco-jaspersoft-studio	JasperReports用のEclipseベースのレポート開発ツール
tic80	小さなゲームを作ったり、遊んだり、共有したりするためのファンタジーコンピュータ
tickeys	入力時に音声フィードバックを生成するためのユーティリティ
ticktick	やること＆タスクリストマネージャー
tidal	忠実度の高いサウンドと高解像度のビデオ品質を備えた音楽ストリーミングサービス
tiddly	TiddlyWiki
tidelift	Tideliftシステムと対話するためのツール
tidgi	個人知識ベースアプリ
tifig	Tifig
tiger-trade	取引プラットフォーム
tigerjython	Jythonベースの教育プログラミング環境
tigervnc-viewer	マルチプラットフォームVNCクライアントおよびサーバー
tigervpn	tigerVPN
tikz-editor	TikZエディター
tikzit	PGF / TikZダイアグラムエディター
tiled	柔軟なレベルエディタ
tiles	ウィンドウマネージャー
timche-gmail-desktop	非公式のGmailデスクトップアプリ
time-lapse-assembler	一連の画像からムービーを作成するためのツール
time-out	休憩のカスタマイズ可能なタイミング
time-sink	コンピューターでの時間を追跡します
time-to-leave	勤務時間を記録し、オフィスを離れる時間になると通知を受け取ります
time-tracker	TimeTracker
timecamp	TimeCampソフトウェアのクライアントアプリケーション-時間の追跡とタスクの変更
timelane	Timelane
timely	Timely
timemachineeditor	TimeMachineのデフォルトのバックアップ間隔を変更するユーティリティ
timemator	自動タイムトラッキングアプリケーション
timer	ストップウォッチ、目覚まし時計、時計ユーティリティ
timestamp	メニューバーの時計を改善
timeular	物理デバイスによるタイムトラッキング
timing	自動時間と生産性追跡アプリ
timings	Timings
tinderbox	メモを取り、視覚化し、分析するためのツール
tinkerwell	PHPおよびLaravel開発者向けのTinkerツール
tint	テールウィンドCSSカラーピッカー
tiny-player	メディアプレーヤー
tinymediamanager	メディア管理ツール
tinypng4mac	TinyPNGクライアント
tip	任意のアプリで使用できるプログラム可能なツールチップ
tipp10	フリータッチタイピングチューター
tla-plus-toolbox	TLA +用のIDE
tlv	Tableau Log Viewer
tn3270-x	IBM3270端末を使用するコンピューターに接続するための端末エミュレーター
tnefs-enough	MicrosoftTNEFファイルからファイルを読み取って抽出します
today-scripts	今日のスクリプト
todoist	やることリスト
todometer	メーターベースのやることリスト
todotxt	ミニマリスト、キーボード駆動のToDoマネージャー
todour	Todo.txtアプリケーションTodour
tofu	Tofu
toggl-track	タイムトラッカー
toinane-colorpicker	カラーコードを取得して保存する
toland-qlmarkdown	Markdownファイル用のQuickLookジェネレーター
tomighty	ポモドーロデスクトップタイマー
tongbu	携帯電話管理ツール
tonido	Tonido
toolreleases	最新のAppleツールリリース（ベータリリースを含む）について通知するユーティリティ
toontown-rewritten	ディズニーのトゥーンタウンオンラインのファンによる復活
topcat	表形式データ用のインタラクティブなグラフィカルビューアおよびエディタ
topnotch	ノッチを隠すユーティリティ
toptracker	タイムトラッキングと請求書処理
tor-browser	セキュリティに重点を置いたWebブラウザ
torguard	VPNクライアント
torrent-file-editor	トレントファイルエディタ
tortoisehg	Mercurial分散リビジョン管理システム用のツール
touch-bar-simulator	スタンドアロンアプリとしてのタッチバー
touch-portal	マクロリモコン
touchbarserver	TouchBarServer
touchdesigner	ダイナミックなデジタルアートを作成するためのツール
touchosc	MIDIおよびOSCコントローラーソフトウェア
touchosc-bridge	OSCおよびMIDI用のモジュラータッチコントロールサーフェスブリッジ
touchosc-editor	OSCおよびMIDI用のモジュラータッチコントロールサーフェスエディター
touchswitcher	タッチバーを使用してアプリを切り替えます
tower	パワーと生産性に焦点を当てたGitクライアント
townwifi	TownWiFi
trackerzapper	リンク追跡パラメータを自動的に削除するメニューバーアプリ
trader-workstation	トレーディングソフトウェア
tradingview	投資トレーダーのためのチャートとソーシャルネットワーキング
trailer	GitHubおよびGitHubEnterpriseのプルリクエストと問題の管理
trainerroad	サイクリングトレーニングシステム
transcribe	録音された音楽を書き写す
transfer	スタンドアロンTFTP、FTP、およびSFTPサーバー
transmission	オープンソースのBitTorrentクライアント
transmission-remote-gui	伝送リモートGUI
transmit	ファイル転送アプリケーション
transnomino	バッチ名前変更ユーティリティ
transocks	さまざまなビデオ音楽リソースへのアクセスを最適化するツール
trash-it	詰まったゴミを削除するツール
treesheets	オープンソースの階層型スプレッドシートとアウトラインアプリケーション
tresorit	Tresorit
trex	使いやすいテキスト抽出ツール
trezor-bridge	Trezorデバイスとサポートされているブラウザ間の通信を容易にします
trezor-suite	Trezorハードウェアウォレット用のコンパニオンアプリ
tribler	P2Pコンテンツ検出を備えたプライバシー強化されたBitTorrentクライアント
trilium-notes	個人知識ベース
trim-enabler	SSDパフォーマンスのトリムを有効にする
trinity	暗号通貨ウォレット
triplecheese	甘美で安っぽいシンセサイザー
tripmode	低速または高価なネットワークでのデータ使用量の制御
trojanx	グレートファイアウォールをバイパスするメカニズム
trolcommander	muCommanderファイルマネージャーのフォーク
tropy	研究写真管理
ttscoff-mmd-quicklook	MMD-QuickLook
tuck	ウィンドウマネージャー
tunein	無料のインターネットラジオ
tuneinstructor	Tune•インストラクター
tuneskit-m4v-converter	TunesKitM4Vコンバーター
tunnelbear	安全なインターネットアクセスとプライベートブラウジングのためのVPNクライアント
tunnelblick	無料のオープンソースOpenVPNクライアント
tuple	リモートペアプログラミングアプリ
turbo-boost-switcher	Intel CPU TurboBoost機能を有効または無効にします
turbovnc-viewer	リモートディスプレイシステム
turtl	turtl
tusk	洗練されたEvernoteデスクトップアプリ
tutanota	メールクライアント
tuxera-ntfs	ファイルシステムおよびストレージ管理ソフトウェア
tuxguitar	マルチトラックギタータブ譜エディターおよびプレーヤー
tv-browser	電子テレビガイド
tvrenamer	TVリストからTVエピソードの名前を変更するユーティリティ
tweet-tray	気を散らすことなく、デスクトップからすばやくツイートする
tweetbot	Twitterクライアント
tweeten	Twitterクライアント
twilioquest	16ビットゲームでクラウドを保存するミッションでクルーをコーディングして導く方法を学びましょう
twine	インタラクティブで非線形のストーリーを伝えるためのツール
twist	チームコミュニケーションおよびコラボレーションソフトウェア
twitch	けいれん
twitterrific	Twitterクライアント
twobird	共同メモをクライアントにメールで送信
twonkyserver	DLNA / UPnPメディアサーバー
tyke	Tyke
tyme	タイムトラッキングアプリ
typeface	フォントマネージャーアプリケーション
typeit4me	テキストエキスパンダー
typinator	頻繁に使用するテキストやグラフィックの挿入を自動化するツール
typora	Markdownをサポートする構成可能なドキュメントエディタ
tysimulator	iPhoneシミュレーターアプリにすばやくアクセスするためのユーティリティ
ubar	ウィンドウマネージャーと生産性ツール
ubersicht	コマンドを実行し、その出力をデスクトップに表示します
ubports-installer	モバイルデバイスにubportsをインストールするためのアプリケーション
udeler	Udemyコースをダウンロードするためのデスクトップアプリケーション
udig	uDig
ueli	キーストロークランチャー
ui-browser	AppleのアクセシビリティとAppleScriptGUIスクリプティングのアシスタント
ujam	UJAM製品の管理ツール 
ukelele	Unicodeキーボードレイアウトエディタ
ukrainian-unicode-layout	ウクライナのUnicodeレイアウト
ultdata	iPhoneデータ回復ソフトウェア
ultimaker-cura	3DプリンターとスライスGUI
ultimate	電子書籍のDRMを変換して削除する
ultimate-control	コンピューターをワイヤレスで制御する
ultracopier	ファイルコピーダイアログの置換
ultrastardeluxe	カラオケゲーム
unclack	入力中にキーボードをミュートします
unclutter	メモ、ファイル、厚紙クリップ用のデスクトップストレージエリア
uncolored	テーマ付きのドキュメントを保存するリッチテキスト（HTML＆Markdown）エディター
uncrustifyx	ユーティリティとドキュメントブラウザのクラスト化を解除します
understand	コードの視覚化と探索ツール
unetbootin	Linux/BSDディストリビューションをパーティションまたはUSBドライブにインストールするためのツール
unexpectedly	クラッシュからのレポートを参照して視覚化する
unicodechecker	Unicodeを調べて変換する
unified-remote	ユニファイドリモート
uniflash	マイクロコントローラ用のフラッシュツール
uninstallpkg	PKGソフトウェアパッケージアンインストールツール
unipro-ugene	無料のオープンソースクロスプラットフォームバイオインフォマティクスソフトウェア
unison	ファイルシンクロナイザー
unite	ウェブサイトをアプリに変える
unity	3Dコンテンツ用のプラットフォーム
unity-android-support-for-editor	UnityのAndroidターゲットサポート
unity-hub	Unityの管理ツール
unity-ios-support-for-editor	UnityのiOSターゲットサポート
unity-webgl-support-for-editor	UnityのWebGLターゲットサポート
unity-windows-support-for-editor	UnityのWindows（Mono）ターゲットサポート
universal-battle	リアルタイムマルチプレイヤー卓上戦争ゲーム
universal-gcode-platform	CNC用Gコードセンダー（GRBL、TinyG、g2core、Smoothiewareと互換性があります）
universal-media-server	DLNA、UPnP、HTTP（S）をサポートするメディアサーバー
unlox	指紋でコンピューターのロックを解除します
unnaturalscrollwheels	物理的なスクロールホイールのスクロール方向を反転するツール
unpkg	パッケージ内のすべてのファイルを解凍する.pkgおよび.mpkgのUnarchiver
unshaky	Appleのバタフライキーボードでのダブルキー押下のソフトウェア修正
upm	パスワードマネージャー
upterm	21世紀のターミナルエミュレータ
upwork	フリーランスのための仕事の市場
usage	アプリケーションの使用状況を追跡します
usb-overdrive	USBおよびBluetoothデバイスドライバー
usbimager	ディスクイメージとUSBドライブへの書き込み/読み取りが可能な非常に最小限のGUIアプリ
usenapp	ニュースリーダーとUsenetクライアント
usr-sse2-rdm	Retinaディスプレイをカスタム解像度に設定する
utc-menu-clock	メニューバー時計
utm	QEMUを使用した仮想マシンUI
utools	プラグイン生産性向上ツールセット
utterly	音声会議またはビデオ会議アプリで通話中のバックグラウンドノイズを除去する
uu-booster	ネットワークアクセラレータ
uvtools	MSLA/DLP、ファイル分析、キャリブレーション、修復、変換、操作
uxprotect	UXProtect
v2rayu	専用の基本的な通信ネットワークを構築するためのツールのコレクション
v2rayx	v2rayコアのGUI
vagrant	開発環境
vagrant-manager	Vagrant Manager
vagrant-vmware-utility	VagrantVMwareプラグインにさまざまなVMware機能へのアクセスを提供します
vale-server	クロスプラットフォームのデスクトップアプリケーション
valentina-studio	データ用のビジュアルエディター
valkyrie	ファンタジーフライトボードゲームのゲームマスター
valley	PCハードウェアのパフォーマンスと安定性をテストするソフトウェア
vallum	アプリケーションファイアウォール
vamiga	Amiga 500、1000、2000エミュレーター
vanilla	メニューバーアイコンを非表示にするツール
vapor	視覚化および分析プラットフォーム
vassal	ボードゲームエンジン
vb-cable	あるアプリケーションから別のアプリケーションにオーディオをルーティングするための仮想オーディオケーブル
vcv-rack	オープンソースの仮想モジュラーシンセサイザー
veepn	VPNクライアント
vellum	電子ブック作成ソフトウェア
veracrypt	TrueCryptに基づくセキュリティに焦点を当てたディスク暗号化ソフトウェア
versions	Subversionクライアント
vesta	電子的および構造的分析のための視覚化
veusz	科学的プロットアプリケーション
via	VIA
vial	互換性のあるキーボードのリアルタイムのConfigurator
viber	セキュリティに焦点を当てた通話およびメッセージングアプリケーション
vidcutter	メディアカッターとジョイナー
videoduke	ビデオダウンローダー
videofusion	動画編集者
videostream	パソコンからChromecastにメディアをストリーミングする
vidl	youtube-dlのGUIフロントエンド
vidrio	プレゼンテーションデザインツール
vidyo	Vidyo
vienna	RSSとAtomリーダー
vimediamanager	ViMediaManager
vimr	NeovimテキストエディタのGUI
vin047-abgx360	vin047-abgx360
vine-server	VNCサーバー
vip-access	2段階認証ソフトウェア
vipriser	印刷可能な任意のアプリケーションからPDFを作成します
virtual-ii	仮想 ][
virtualbox	x86ハードウェア用のバーチャライザー
virtualbox-extension-pack	VirtualBoxの機能を拡張する
virtualc64	サイクル精度の高いC64エミュレーター
virtualgl	境界のない3D
virtualhere	ネットワーク経由でリモートでUSBデバイスを使用する
virtualhereserver	ネットワーク経由で接続されたUSBデバイスにリモートアクセス
virtualhostx	ローカルサーバー環境
viscosity	安全なインターネットアクセスとプライベートブラウジングのためのVPNクライアント
visit	メッシュベースの科学データの視覚化とデータ分析
visual	ARMアセンブリ言語を学ぶ
visual-paradigm	UML 2、SysML、およびビジネスプロセスモデリング表記をサポートするUMLCASEツール
visual-paradigm-ce	アジャイル向けのオールインワンUML、SysML、BPMNモデリングプラットフォーム
visual-studio	統合開発環境
visual-studio-code	オープンソースコードエディタ
visualboyadvance-m	Visual Boy Advance-M
visualvm	オールインワンJavaトラブルシューティングツール
vitals	小さなプロセスモニター
vitalsigns	温度およびメモリモニター
vitalsource-bookshelf	eTextbooksにアクセスする
vitamin-r	生産性ツールと技術のコレクション
vivaldi	カスタマイズと制御に焦点を当てたWebブラウザ
vk-messenger	メッセンジャーアプリ
vlc	マルチメディアプレーヤー
vlc-setup	VLCRemoteのVLCを設定する
vlc-webplugin	Webブラウザプラグイン
vlcstreamer	VLCを使用してモバイルデバイスにビデオをストリーミングする
vmpk	仮想MIDIピアノキーボード
vmware-fusion	仮想マシンを作成、管理、および実行する
vmware-horizon-client	仮想マシンクライアント
vnc-server	リモートデスクトップサーバーアプリケーション
vnc-viewer	セキュリティに重点を置いたリモートデスクトップアプリケーション
vnote	メモを取るプラットフォーム
vofa-plus	プラグインによって駆動されるシリアルポートコンソール
voicemac	VoiceMac
voikkospellservice	VoikkoSpellService
volanta	パーソナルフライトトラッカー
volley	非同期ビデオメッセージングアプリ
volt	Slack、Discord、Skype、Gmail、Twitter、Facebookなどのクライアント
voodoopad	ノートオーガナイザー
voov-meeting	国境を越えたビデオ会議ソフトウェア
vorta	ボーグのデスクトップバックアップクライアント
vox	外部ソースを介した高解像度（Hi-Res）音楽用の音楽プレーヤー
vox-preferences-pane	Apple Remote、EarPods、システムボタン用のVOXアドオン
voxql	voxql
vpn-enabler	VPNイネーブラー
vpn-tracker-365	VPNクライアント：IPsec、L2TP、OpenVPN、PPTP、SSTP、SonicWALL/AnyConnect/Fortinet SSL
vrew	動画編集者
vscodium	MSブランディング/テレメトリ/ライセンスなしのVSCodeのバイナリリリース
vsd-viewer	Visio図面の.VSD、.VDX、.VSDXファイル形式をプレビューする
vsdx-annotator	Visio図面のプレビュー、編集、変換
vsee	グループビデオ通話、画面共有、インスタントメッセージング
vu	Instagramクライアント
vuescan	サポートされなくなった古いモデルのスキャナー用のドライバーを提供するアプリ
vuze	ビットトレントクライアント
vv	Neovimクライアント
vym	あなたの考えを示す地図を生成して操作する
vyprvpn	VPNクライアント
vysor	スマートフォンをミラーリングして制御する
wacom-inkspace	ワコムインクスペース
wail	Webアーカイブ統合レイヤー：ワンクリックのユーザー主導の保存
wallpaper-wizard	調整可能な壁紙アプリケーション
waltr	Appleデバイス用のメディア直接転送ツール
waltr-heic-converter	HEICからJPEGへの画像コンバーターをドラッグアンドドロップします
waltr-pro	Appleデバイス用のメディア変換および直接転送ツール
wannianli	メニューバーの中国の太陰暦
warsow	一人称シューティングゲーム
warzone-2100	無料のオープンソースリアルタイム戦略ゲーム
wasabi-wallet	オープンソース、非管理、プライバシーに焦点を当てたビットコインウォレット
watchguard-mobile-vpn-with-ssl	SSLを使用したWatchGuardMobile VPN
waterfox	ウェブブラウザ
waterfox-classic	ウェブブラウザ
wavebox	ウェブブラウザ
waves-central	Waves製品をインストールしてアクティブ化するクライアント
wavesurfer	WaveSurfer
weakauras-companion	Wago.ioからオーラを更新し、それらの定期的なバックアップを作成します
webarchiveextractor	Webアーカイブファイルからディレクトリにコンテンツを抽出します
webcamoid	ウェブカモイド
webcatalog	デスクトップアプリのようなウェブアプリを実行するためのツール
webex	ビデオ通信および仮想会議プラットフォーム
webex-meetings	ビデオ通信および仮想会議プラットフォーム
webots	ロボットのシミュレーションに使用されるオープンソースのデスクトップアプリケーション
webpack-dashboard	Webpackダッシュボード用のElectronデスクトップGUI
webplotdigitizer	プロット画像から数値データを抽出する
webpquicklook	WebPQuickLook
webrecorder-player	Webrecorderプレーヤー
website-watchman	ウェブサイトウォッチマン
webstorm	JavaScript IDE
webtorrent	トレントストリーミングアプリケーション
webull	Webull FinancialLLCのデスクトップクライアント
webviewscreensaver	Webページを表示するスクリーンセーバー
wechat	無料のメッセージングおよび通話アプリケーション
wechatwebdevtools	公式アカウントおよびミニプログラム開発用のWeixinDevTools
wechatwork	メッセージングおよび通話アプリケーション
weiyun	ドキュメントのバックアップとオンライン管理
weka	データマイニングタスク用の機械学習アルゴリズムのコレクション
welly	BBSクライアント
wercker	Wercker
wewechat	非公式のWeChatクライアント
wey	オープンソースのSlackデスクトップアプリ
wezterm	GPUで高速化されたクロスプラットフォームのターミナルエミュレーターとマルチプレクサー
whale	非公式のTrelloアプリ：クジラ：
whalebird	マストドン、プレローマ、ミスキーのクライアント
whatroute	ネットワーク診断ユーティリティ
whatsapp	WhatsApp用のデスクトップクライアント
whatsize	ディスクスペースの表示と再利用に使用されるファイルシステムユーティリティ
whatsyoursign	ファイルの暗号署名情報を表示します
whichspace	アクティブスペースメニューバーアイコン
whoozle-android-file-transfer	Linux用のAndroidファイル転送
wickrme	WickrMeのデスクトップクライアント
widelands	SettlersIIのような無料のリアルタイム戦略ゲーム
wifi-explorer	ワイヤレスネットワークのスキャン、監視、およびトラブルシューティング
wifi-explorer-pro	ワイヤレスネットワークのスキャン、監視、およびトラブルシューティング
wifispoof	コンピュータのMACアドレスを変更する
winclone	BootCampのクローン作成とバックアップソリューション
window-switch	ウィンドウスイッチ
windows95	Electron Windows 95
winds	Getstream.ioを利用したオープンソースのRSSおよびポッドキャストアプリ
windscribe	安全なインターネットアクセスとプライベートブラウジングのためのVPNクライアント
wine-stable	Windowsアプリケーションを実行するための互換性レイヤー
wing-personal	学生や愛好家のために設計された無料のPythonIDE
wings3d	高度なサブディビジョンモデラー
wintertime	バッテリーを節約するためにバックグラウンドで実行されているアプリをフリーズするユーティリティ
winx-hd-video-converter	HDビデオコンバーター
winzip	WinZip
wire	セキュリティに焦点を当てたコラボレーションプラットフォーム
wireframe-sketcher	WireframeSketcher
wireshark	ネットワークプロトコルアナライザ
wireshark-chmodbpf	ネットワークプロトコルアナライザ
witch	アプリ、ウィンドウ、またはタブを切り替える
wiznote	WizNote
wjoy	任天堂　wiimoteドライバー
wkhtmltopdf	wkhtmltopdf
wolai	クラウドノート
wolfram-engine	Wolfram言語の評価者
wombat	クロスプラットフォームgRPCクライアント
wonderfultools-screensaver	素晴らしいツールのスクリーンセーバー
wondershare-edrawmax	ダイアグラムソフトウェア
wondershare-filmora	動画編集者
wondershare-uniconverter	ビデオ編集ソフトウェア
wordpresscom	WordPressクライアント
wordservice	選択したテキストを操作するためのコマンドを提供するツール
workbench	シームレス、自動、"dotfile"iCloudに同期する 
workflowy	メモを取るツール
workplace-chat	組織のコミュニケーションポータル
workspaces	ワークスペース整理アプリ
wormhole	PCでの電話の閲覧と制御、iOSとAndroid用のScreen Fusion
wowmatrix	WowMatrix
wowup	World ofWarcraftアドオンマネージャー
wpsoffice	オールインワンのオフィススイート
wrike	プロジェクト管理アプリ
writefull	あなたの執筆に関するフィードバックを提供します
writemapper	マインドマップを使用してテキストドキュメントを作成するのに役立つライティングツール
writer	噴水言語に基づくスクリーンライティングアプリ
wsjtx	弱信号状態の通信プロトコルを実装するアマチュア無線アプリ
wwdc	WWDCライブストリーム、ビデオ、およびセッションへのアクセスを許可します
wxcrafter	wxCrafter
wxmacmolplt	GAMESS用のクロスプラットフォームGUI入力ジェネレーター
x-mirage	X-ミラージュ
x-moto	X-Moto
x-swiftformat	SwiftコードをフォーマットするためのXcode拡張
x2goclient	リモートデスクトップソフトウェア
xamarin-android	.NET開発者にAndroidSDKへの完全なアクセスを提供します
xamarin-ios	.NET開発者にiOS、watchOS、およびtvOSSDKへの完全なアクセスを提供します
xamarin-mac	C＃および.NET開発者にObjective-CおよびSwiftAPIへのアクセスを提供します
xamarin-profiler	Xamarinプロファイラー
xamarin-studio	モバイルアプリ開発のためのIDE
xamarin-workbooks	C＃ドキュメントとコーディング資料
xampp	MySQL、PHP、およびPerlを含むApacheディストリビューション
xampp-vm	MySQL、PHP、およびPerlを含むApacheディストリビューションを備えた仮想マシン
xaos	GNU XaoS
xattred	拡張属性エディタ
xbar	メニューバーにスクリプトからの出力を表示する
xbench	ベンチマークソフトウェア
xca	X証明書とキーの管理
xcodeclangformat	xcodeでclang-formatを使用してコードをフォーマットします
xcodes	Xcodeの複数のバージョンをインストールして切り替えます
xctu	XBee / RFソリューションの構成プラットフォーム
xdm	ダウンロード速度を上げるためのツール
xee	画像ビューアとファイルブラウザ
xiami	音楽コンテンツの管理と配信
ximalaya	ポッドキャスティングとオーディオ共有のためのプラットフォーム
xit	gitバージョン管理システムのGUI
xld	ロスレスオーディオデコーダー
xlplayer	ビデオプレーヤー
xmind	マインドマッピングとブレーンストーミングツール
xmind-zen	マインドマップとブレーンストーミングアプリ
xmplify	XMLエディター
xnconvert	画像変換およびリサイザーツール
xnviewmp	フォトビューア、画像マネージャ、画像リサイザなど
xoctave	Xoctave
xonotic	アリーナスタイルの一人称シューティングゲーム
xournal-plus-plus	手書きのメモ取りソフトウェア
xpra	画面とアプリケーションの転送システム
xquartz	X.OrgXウィンドウシステムのオープンソースバージョン
xrg	システムモニター
xscope	画面上のグラフィックスとレイアウトを測定、検査、テストするためのツール
xscreensaver	スクリーンセーバー
xstation5	デスクトップ取引プラットフォーム
xtorrent	トレントクライアント
yacreader	コミックリーダー
yakyak	Googleハングアウト用のデスクトップチャットクライアント
yam-display	さらに別のモニター
yammer	Yammer用のデスクトップクライアント
yandex	ウェブブラウザ
yandex-cloud-cli	Yandex Cloud CLI
yandex-disk	クラウドストレージ
yate	メディアファイルタグエディタ
yed	ダイアグラムを手動で作成するか、分析のために外部データをインポートします
yemuzip	YemuZip
yep	ドキュメントマネージャー
yesplaymusic	サードパーティのNetEaseクラウドプレーヤー
yggdrasil	世界をつなぐエンドツーエンドの暗号化されたIPv6ネットワーキング
yinxiangbiji	アプリを取ることに注意してください
yippy	オープンソースクリップボードマネージャー
yo	コマンドラインから通知センターメッセージを送信するユーティリティ
yoda	YouTubeビデオを閲覧およびダウンロードするためのアプリ
yojimbo	よじんぼ
youdaodict	Youdao 辞典
youdaonote	マルチプラットフォームノートアプリケーション
youku	中国のビデオストリーミングおよび共有プラットフォーム
youll-never-take-me-alive	暗号化されたデータの保護を強化するユーティリティ
youtrack-workflow	YouTrackのワークフローを作成および編集します
youtube-downloader	YouTube映画をダウンロードするためのシンプルなメニューバーアプリ
youtube-to-mp3	プレイリストまたはチャンネルから音楽をダウンロードします
yt-music	music.youtube.comのアプリラッパー
ytmdesktop-youtube-music	YouTubeミュージッククライアント
yu-writer	マークダウンエディタ
yuna	アニメプレイヤー兼リストマネージャー
yuque	クラウドナレッジベース
zalo	メッセージングおよび通話アプリケーション
zandronum	DoomおよびDoomII用のマルチプレイヤー指向のポート
zappy	リモートチーム用の画面キャプチャツール
zazu	ハッカー、クリエーター、ダブラー向けの拡張可能なオープンソースランチャー
zdoom	ZDoom
zebra2	ワイヤレスモジュラーシンセサイザー
zecwallet-lite	Zcashライトウォレット
zeebe-modeler	BPMNを使用してZeebeワークフローをモデル化するためのデスクトップアプリケーション
zeitgeist	Vercelの展開に注意してください
zenbeats	音楽作成アプリ
zenmap	公式のNmapセキュリティスキャナー用のマルチプラットフォームグラフィカルインターフェイス
zenmate-vpn	ZenMate VPN
zeplin	デザインの共有、整理、コラボレーション
zerobranestudio	Lua IDE
zeronet	ZeroNet
zerotier-one	メッシュVPNクライアント
zesarux	ZEsarUX
zettelkasten	ルーマンによるノートボックス
zettlr	オープンソースのマークダウンエディタ
zoc	プロフェッショナルSSHクライアントおよびターミナルエミュレータ
zoho-docs	Zoho Docs
zoho-mail	メールクライアント
zoho-workdrive	Zohoクラウドストレージサービスのクライアント
zoom	ビデオ通信および仮想会議プラットフォーム
zoom-for-it-admins	ビデオ通信および仮想会議プラットフォーム
zoom-outlook-plugin	Zoom.us用のOutlookプラグイン
zoomus	ビデオコミュニケーションツールZoomの一時的な仮のエイリアス
zotero	研究ソースを収集、整理、引用、共有する
zprint	ClojureおよびClojurescriptのソースコードとS式を再フォーマットするためのライブラリ
zterm	ターミナルエミュレーションプログラム
zulip	Zulipチームチャットプラットフォーム用のデスクトップクライアント
zulu	AzulからのOpenJDKディストリビューション
zulufx	Azul ZuluFX Java StandardEdition開発キット
zwift	Zwift
zxpinstaller	Adobe拡張機能インストーラー
zy-player	ビデオリソースプレーヤー
