font-0xproto-nerd-font	開発者向けのグリフ数が多いフォント
font-3270	IBM 3270
font-3270-nerd-font	3270オタクフォント(3270)
font-437-plus	DOS時代のIBMPC及び互換機からのクラシックテキストモードフォントのコレクション
font-abeezee	ABeeZee
font-abel	Abel
font-abhaya-libre	Abhaya Libre
font-aboreto	薄め
font-aboriginal-sans	LanguageGeek アボリジニ Sans Serif
font-aboriginal-serif	Aboriginal Serif
font-abril-fatface	Abril Fatface
font-abyssinica-sil	Abyssinica SIL
font-academicons	学者の為のスペシャリストアイコンフォント
font-aclonica	Aclonica
font-acme	Acme
font-actor	Actor
font-adamina	Adamina
font-adinatha-tamil-brahmi	Adinatha Tamil Brahmi
font-adlam-display	ADLaM Display
font-adobe-blank	Adobe Blank
font-advent-pro	Webとプリント用に設計されたモダンなフォント
font-afacad	Afacad
font-african-sans	African Sans
font-african-serif	African Serif
font-agave-nerd-font	Agave Nerd Font(Agave)
font-agbalumo	シングルウェイトフォント
font-agdasima	Big shouldersをベースに、凝縮されたアメリカンゴシックsans-serif
font-aguafina-script	Aguafina Script
font-ahuramzda	Ahuramzda
font-aileron	Aileron
font-akatab	Akatab
font-akaya-kanadaka	Akaya Kanadaka
font-akaya-telivigala	Akaya Telivigala
font-akronim	Akronim
font-aksara-bali-galang	Aksara Bali Galang
font-akshar	サポートされています
font-aladin	Aladin
font-alata	Alata
font-alatsi	Alatsi
font-albert-sans	モダンで幾何学的な sans serifファミリー
font-albertella	三葉虫に触発された古代生物学スタイルのフォント
font-aldrich	Aldrich
font-alef	Alef
font-alegreya	Alegreya
font-alegreya-sans	Alegreya-Sans
font-alegreya-sans-sc	Alegreya Sans SC
font-alegreya-sc	Alegreya SC
font-aleo	Aleo
font-alex-brush	Alex Brush
font-alexandria	ラテン文字のMontserratに合わせて作られた9ウェイトのフォントファミリー
font-alfa-slab-one	Alfa Slab One
font-alice	Alice
font-alike	Alike
font-alike-angular	Alike Angular
font-alkalami	非常に黒い、塗りつぶされた長方形
font-alkatra	書体ファミリーを表示する
font-allan	Allan
font-allerta	Allerta
font-allerta-stencil	Allerta Stencil
font-allison	カジュアルな手書きスクリプト
font-allura	Allura
font-almarai	Almarai
font-almendra	Almendra
font-almendra-display	Almendra Display
font-almendra-sc	Almendra SC
font-alumni-sans	Alumni Sans
font-alumni-sans-collegiate-one	Impact Blackに触発されたフォント
font-alumni-sans-inline-one	同窓生 Sans Inline One
font-alumni-sans-pinstripe	Alumni Sans Pinstripe
font-amarante	Amarante
font-amaranth	Amaranth
font-amatic-sc	Amatic SC
font-amethysta	Amethysta
font-amiko	Amiko
font-amiri	Naskhスタイルの古典的なアラビア語書体
font-amiri-quran	Amiri Quran
font-amita	Amita
font-amstelvar-alpha	Amstelvar Alpha
font-anaheim	Anaheim
font-andada-pro	Organic-slab serifハイブリッドスタイルとテキスト用ミディアムコントラストタイプ
font-andagii	Andagii
font-andale-mono	Andale Mono
font-andika	読み書き用に設計及び最適化されたSans-serifフォントファミリ
font-andron-scriptor-web	Andron Scriptor Web
font-anek-bangla	Anek Bangla
font-anek-devanagari	Anek Devanagari
font-anek-gujarati	Anek Gujarati
font-anek-gurmukhi	Anek Gurmukhi
font-anek-kannada	Anek Kannada
font-anek-latin	Anek Latin
font-anek-malayalam	Anek Malayalam
font-anek-odia	Anek Odia
font-anek-tamil	Anek Tamil
font-anek-telugu	Anek Telugu
font-angkor	Angkor
font-anka-coder	Anka/Coder
font-annapurna-sil	デヴァナガリ文字を使用するシステムをサポートするUnicodeベースのフォント
font-annie-use-your-telescope	Annie Use Your Telescope
font-anonymice-nerd-font	Anonymice Nerd Font(Anonymous Pro)
font-anonymice-powerline	Anonymice Powerline
font-anonymous-pro	Anonymous Pro
font-anta	特にグラフィック デザインだけでなく、ブランディング プロジェクトにも適しています
font-antic	Antic
font-antic-didone	Antic Didone
font-antic-slab	Antic Slab
font-antinoou	Antinoou
font-anton	Anton
font-antonio	Antonio
font-anuphan	ibm plex sans thaiの変更ではありません
font-anybody	10程度 目立つか微妙
font-aoboshi-one	Aoboshi One
font-ar-one-sans	タイプファミリは拡張現実環境及びユーザーインターフェイスで使用する為のものです
font-arapey	Arapey
font-arbutus	Arbutus
font-arbutus-slab	Arbutus Slab
font-architects-daughter	Architects Daughter
font-architype-renner	Architype Renner
font-archivo	Archivo
font-archivo-black	Archivo Black
font-archivo-narrow	Archivo Narrow
font-are-you-serious	とても楽しい精神を持った楽しい遊び心のあるフォント
font-aref-ruqaa	Aref Ruqaa
font-aref-ruqaa-ink	カリド・ホスニーが率いる カイロを拠点とする書体デザイナー エジプト
font-arial	Arial
font-arial-black	Arial Black
font-arima	ndiscoverが主導 ポルトガルを拠点とするタイプデザインファウンドリ
font-arimo	Arimo
font-arimo-nerd-font	Arimo Nerd Font(Arimo)
font-arizonia	Arizonia
font-ark-pixel-10px-monospaced	オープンソースのPan-CJKピクセルフォント
font-ark-pixel-10px-proportional	オープンソースのPan-CJKピクセルフォント
font-ark-pixel-12px-monospaced	オープンソースのPan-CJKピクセルフォント
font-ark-pixel-12px-proportional	オープンソースのPan-CJKピクセルフォント
font-ark-pixel-16px-monospaced	オープンソースのPan-CJKピクセルフォント
font-ark-pixel-16px-proportional	オープンソースのPan-CJKピクセルフォント
font-armata	Armata
font-arsenal	Arsenal
font-artifika	Artifika
font-arvo	Arvo
font-arya	Arya
font-asap	Asap
font-asap-condensed	Asap Condensed
font-asar	Asar
font-asset	Asset
font-assistant	Assistant
font-astloch	Astloch
font-asul	Asul
font-athiti	Athiti
font-atkinson-hyperlegible	視覚障害向けの読みやすさを備えたフォント
font-atma	Atma
font-atomic-age	Atomic Age
font-aubrey	Aubrey
font-audiowide	Audiowide
font-aurulent-sans-mono-nerd-font	AurulentSansMonoオタクフォント(Aurulent Sans Mono)
font-autour-one	Autour One
font-average	Average
font-average-mono	Average Mono
font-average-sans	Average Sans
font-averia-gruesa-libre	Averia Gruesa Libre
font-averia-libre	Averia Libre
font-averia-sans-libre	Averia Sans Libre
font-averia-serif-libre	Averia Serif Libre
font-awesome-terminal-fonts	素晴らしいターミナルフォント
font-azeret-mono	martinváchaとdanielquisekによるデザイン
font-azonix	モダンなsans-serif書体
font-b612	B612
font-b612-mono	B612 Mono
font-babylonica	直立または逆傾斜のフォームによってさえぎられ強調が発生します
font-bacasime-antique	様式的には過渡的なデザイン
font-bad-script	Bad Script
font-bagel-fat-one	Bagel Fat One
font-bahiana	Bahiana
font-bahianita	Bahianita
font-bai-jamjuree	Bai Jamjuree
font-bakbak-one	警告から嘲笑まで何でもレンダリングします
font-ballet	maximiliano sprovieroによって設計され、eduardotunniによって開発されました
font-baloo	Baloo
font-baloo-2	Baloo 2
font-baloo-bhai-2	Baloo Bhai 2
font-baloo-bhaijaan-2	Baloo Bhaijaan 2
font-baloo-bhaina-2	Baloo Bhaina 2
font-baloo-chettan-2	Baloo Chettan 2
font-baloo-da-2	Baloo Da 2
font-baloo-paaji-2	Baloo Paaji 2
font-baloo-tamma-2	Baloo Tamma 2
font-baloo-tammudu-2	Baloo Tammudu 2
font-baloo-thambi-2	Baloo Thambi 2
font-balsamiq-sans	Balsamiq Sans
font-balthazar	Balthazar
font-bangers	Bangers
font-barlow	Barlow
font-barlow-condensed	Barlow Condensed
font-barlow-semi-condensed	Barlow Semi Condensed
font-barriecito	Barriecito
font-barrio	Barrio
font-basic	Basic
font-baskervville	Baskervville
font-battambang	Battambang
font-baumans	Baumans
font-bayon	Bayon
font-be-vietnam-pro	ハイテク企業やスタートアップに最適
font-beau-rivage	太いストロークと細いストロークのコントラストが強い古典的な書体
font-bebas-neue	Bebas Neue
font-belanosima	1920年代の幾何学的な sans serifデザインから影響を受けたもの
font-belgrano	Belgrano
font-bellefair	Bellefair
font-belleza	Belleza
font-bellota	Bellota
font-bellota-text	Bellota Text
font-benchnine	BenchNine
font-benne	ジョン・ハリントンによって開発されたKannadaテキストフォント
font-bentham	Bentham
font-berkshire-swash	Berkshire Swash
font-besley	Designed by owen earl(indestructible type*)
font-beth-ellen	Beth Ellen
font-bevan	Bevan
font-bhavuka	Bhavuka
font-bhutuka-expanded-one	Gurmukhiの仲間 aoifemooneyのbiorhyme拡張ライト書体
font-big-shoulders-display	Big Shouldersディスプレイ
font-big-shoulders-inline-display	凝縮されたアメリカンゴシック書体のスーパーファミリー
font-big-shoulders-inline-text	凝縮されたアメリカンゴシック書体のスーパーファミリー
font-big-shoulders-stencil-display	凝縮されたアメリカンゴシック書体のスーパーファミリー
font-big-shoulders-stencil-text	凝縮されたアメリカンゴシック書体のスーパーファミリー
font-big-shoulders-text	Big Shouldersテキスト
font-bigblue-terminal-nerd-font	BigBlue_Terminalオタクフォントファミリ(BigBlueターミナル)
font-bigelow-rules	Bigelow Rules
font-bigshot-one	Bigshot One
font-bilbo	Bilbo
font-bilbo-swash-caps	Bilbo Swash Caps
font-biorhyme	ラテン書体ファミリー
font-biorhyme-expanded	BioRhyme拡張
font-birthstone	キャップとエンディングのスワッシュフォームを含む弾むbirthstone兄弟
font-birthstone-bounce	より光沢と遊び心を加えるbirthstoneの兄弟ファミリー
font-biryani	Biryani
font-bitstream-vera	Bitstream Vera
font-bitstream-vera-sans-mono-nerd-font	BitstreamVeraSansMonoオタクフォント(Bitstream Vera Sans Mono)
font-bitter	電子インク画面用に最適化されたSlab-serif書体
font-bitter-ht	電子インク画面用に最適化されたSlab-serif書体
font-biz-udgothic	BIZ UDGothic
font-biz-udmincho	日本の明朝体伝統のユニバーサルデザイン書体
font-biz-udpgothic	BIZ UDPGothic
font-biz-udpmincho	日本の明朝体伝統のユニバーサルデザイン書体
font-black-and-white-picture	黒と白の画像
font-black-han-sans	Black Han Sans
font-black-ops-one	Black Ops One
font-blackout	Blackout
font-blaka	現在、グーグルクローム(バージョン98以降)の様な幾つかのアプリケーションに限定されています
font-blaka-hollow	Blaka Hollow
font-blaka-ink	Blaka Ink
font-blex-mono-nerd-font	BlexMonoオタクフォント(IBM Plex Mono)
font-blinker	Blinker
font-blokk-neue	BLOKK Neue
font-bm	BM
font-bodoni-moda	コントラストの高いSerif書体
font-bokor	Bokor
font-bona-nova	Cursive typeface
font-bonbon	Bonbon
font-bonheur-royale	Bonheur Royale
font-boogaloo	Boogaloo
font-borel	French cursive primer
font-bowlby-one	Bowlby One
font-bowlby-one-sc	Bowlby One SC
font-braah-one	大胆で遊び心のあるフォント
font-brawler	Brawler
font-bree-serif	Bree Serif
font-bricolage-grotesque	歴史的資料、技術的な決定、個人的な感情のコラージュ
font-briem-hand	16世紀筆記体の現代版
font-brill	Brill
font-bruno-ace	Bruno Ace
font-bruno-ace-sc	Bruno Ace SC
font-brygada-1918	Webサイトプロジェクトで利用可能
font-bubblegum-sans	Bubblegum Sans
font-bubbler-one	Bubbler One
font-buda	Buda
font-buenard	Buenard
font-bukyvede-bold	BukyVede Bold
font-bukyvede-italic	BukyVede Italic
font-bukyvede-regular	BukyVede Regular
font-bungee	縦型及び多色タイポグラフィ用のフォント
font-bungee-color	米国を拠点とする書体デザイナー、デビッド・ジョナサン・ロスが率いる
font-bungee-hairline	Bungee Hairline
font-bungee-inline	Bungee Inline
font-bungee-outline	Bungee Outline
font-bungee-shade	Bungee Shade
font-bungee-spice	sil openフォントライセンスの下でリリース
font-butcherman	Butcherman
font-butterfly-kids	Butterfly Kids
font-cabin	Cabin
font-cabin-condensed	Cabin Condensed
font-cabin-sketch	Cabin Sketch
font-caesar-dressing	Caesar Dressing
font-cagliostro	Cagliostro
font-cairo	Cairo
font-cairo-play	カラーマークが特徴的なCairoのカラーフォントバージョン
font-cal-sans	幾何学的 sans-serif書体
font-caladea	Caladea
font-calistoga	Calistoga
font-calligraffitti	Calligraffitti
font-cambay	Cambay
font-cambo	Cambo
font-camingocode	CamingoCode
font-candal	Candal
font-cantarell	Cantarell
font-cantata-one	Cantata One
font-cantora-one	Cantora One
font-caprasimo	Based on fraunces
font-capriola	Capriola
font-caramel	3つのバリエーションを持つ楽しい手書きのスクリプト
font-carattere	フォーマルなエレガンスと美しさが不可欠​​な場所に最適
font-cardo	Cardo
font-carlito	calibriとのメトリック互換
font-carme	Carme
font-carrois-gothic	Carrois Gothic
font-carrois-gothic-sc	Carrois Gothic SC
font-carter-one	Carter One
font-cascadia-code	プログラミング合字を含む等幅フォント
font-cascadia-code-pl	Powerline記号が埋め込まれたCascadiaコードのバージョン
font-cascadia-mono	合字のないCascadiaコードのバージョン
font-cascadia-mono-pl	糸結びがなく、Powerlineが埋め込まれたCascadiaコードのバージョン
font-caskaydia-cove-nerd-font	CaskaydiaCove Nerdフォント(Caskaydiaコード)
font-caskaydia-mono-nerd-font	開発者向けのグリフ数が多いフォント
font-castoro	北米ビーバーにちなんで名付けられました castor canadensis
font-castoro-titling	Castoro Titling
font-catamaran	Catamaran
font-caudex	Caudex
font-caveat	Caveat
font-caveat-brush	Caveat Brush
font-cedarville-cursive	Cedarville Cursive
font-ceviche-one	Ceviche One
font-chakra-petch	Chakra Petch
font-changa	Changa
font-changa-one	Changa One
font-chango	Chango
font-chapbook	Chapbook
font-charis-sil	ラテン文字とキリル文字を使用する言語をサポートするUnicodeベースのフォントファミリ
font-charm	Charm
font-charmonman	Charmonman
font-charter	Charter
font-chathura	Chathura
font-chau-philomene-one	Chau Philomene One
font-chela-one	Chela One
font-chelsea-market	Chelsea Market
font-chenla	Chenla
font-chenyuluoyan	オープンソースの繁体字中国語手書きフォント
font-cherish	表現力と洗練さをプラスしたドライブラシスタイル
font-cherry-bomb-one	Cherry Bomb One
font-cherry-cream-soda	Cherry Cream Soda
font-cherry-swash	Cherry Swash
font-chewy	Chewy
font-chiayi-city	ChiaYi-cityのカリスマ性を反映したフォント
font-chicle	Chicle
font-chilanka	Chilanka
font-chiron-hei-hk	モダン、地域に依存しない伝統的な中国語の書体 sans serif
font-chiron-sung-hk	モダン、地域に依存しない伝統的な中国語の書体 sans serif
font-chivo	Chivo
font-chivo-mono	細いフォントから黒のフォントまでイタリック体が一致するバリアブルフォン
font-chokokutai	文字が面白い外観の日本語表示フォント
font-chomsky	New York Timesのマストヘッド フルフォントとして再考
font-chonburi	Chonburi
font-church-slavonic	教会スラヴフォント
font-cica	Cica
font-cinzel	Cinzel
font-cinzel-decorative	Cinzel Decorative
font-clear-sans	Clear Sans
font-clicker-script	Clicker Script
font-climate-crisis	Climate Crisis
font-cochineal	Cochineal
font-coda	Coda
font-code-new-roman-nerd-font	CodeNewRomanオタクフォント(Code New Roman)
font-code2002	Code2002
font-codicon	Visual Studio Code のアイコンフォント
font-codystar	Codystar
font-coelacanth	ブルース・ロジャースのCentaurに触発されたSerif書体
font-coiny	Coiny
font-combo	Combo
font-comfortaa	Comfortaa
font-comforter	多くの用途にアピール
font-comforter-brush	comforter Brushyの仲間 弾む 直立したブラシスタイルのスクリプト
font-comic-mono	読みやすい等幅フォント
font-comic-neue	古典的 comic sansのオリジナルの再解釈
font-comic-sans-ms	Comic Sans
font-comic-shanns-mono-nerd-font	多数のグリフを含む開発者向けのフォント
font-coming-soon	Coming Soon
font-comme	可変、細いものから黒いものまでのウェイト軸
font-commissioner	ほぼ古典的な比率の低コントラストのヒューマニストsans-serifフォント
font-commit-mono	ニュートラルなプログラミング書体
font-commit-mono-nerd-font	開発者向けのグリフ数が多いフォント
font-computer-modern	Computer Modern
font-conakry	Conakry
font-concert-one	Concert One
font-condiment	Condiment
font-consolas-for-powerline	Consolas for Powerline
font-constructium	Constructium
font-content	Content
font-contrail-one	Contrail One
font-convergence	Convergence
font-cookie	Cookie
font-cooper-hewitt	修正された幾何学的曲線とアーチで構成された現代的なsans serif
font-copse	Copse
font-corben	Corben
font-corinthia	Corinthia
font-cormorant	Cormorant
font-cormorant-garamond	Cormorant Garamond
font-cormorant-infant	Cormorant Infant
font-cormorant-sc	Cormorant SC
font-cormorant-unicase	Cormorant Unicase
font-cormorant-upright	Cormorant Upright
font-courgette	Courgette
font-courier-new	Courier New
font-courier-prime	Courier Prime
font-courier-prime-code	Courier Prime Code
font-courier-prime-medium-and-semi-bold	Courier Prime Medium & Semi-Bold
font-courier-prime-sans	Courier Prime Sans
font-cousine	Cousine
font-cousine-nerd-font	Cousine Nerd Font(Cousine)
font-coustard	Coustard
font-covered-by-your-grace	あなたの恵みによって覆われています
font-cozette	ビットマッププログラミングフォント
font-crafty-girls	Crafty Girls
font-creepster	Creepster
font-creepster-caps	Creepster Caps
font-crete-round	Crete Round
font-crimson-pro	Crimson Pro
font-crimson-text	Crimson Text
font-croissant-one	Croissant One
font-crushed	Crushed
font-cubic-11	オープンソースの11x11繁体字中国語ビットマップフォント
font-cuprum	Cuprum
font-cute-font	Cute Font
font-cutive	Cutive
font-cutive-mono	Cutive Mono
font-d2coding	D2 Coding
font-d2coding-nerd-font	開発者向けのグリフ数が多いフォント
font-daddy-time-mono-nerd-font	DaddyTimeMonoオタクフォント(DaddyTimeMono)
font-dai-banna-sil	Dai Banna SIL
font-damion	Damion
font-dancing-script	Dancing Script
font-danfo	0/50/100 の3つの主要なスタイルを持つElsh軸可変フォント
font-dangrek	Dangrek
font-darker-grotesque	Darker Grotesque
font-darumadrop-one	Darumadrop One
font-dashicons	Dashicons
font-david-clm	David CLM
font-david-libre	meir sadanが率いる テルアビブを拠点とする書体デザイナー イスラエル
font-dawning-of-a-new-day	新しい日の夜明け
font-days-one	Days One
font-decovar-alpha	Decovar Alpha
font-dejavu	DejaVu
font-dejavu-sans-mono-for-powerline	DejaVu Sans Mono for Powerline
font-dejavu-sans-mono-nerd-font	DejaVu Sans Monoオタクフォント(DejaVu Sans Mono)
font-dekko	Dekko
font-dela-gothic-one	Dela Gothic One
font-delicious-handrawn	agung rohmatの手書きから影響を得たフォント
font-delius	Delius
font-delius-swash-caps	Delius Swash Caps
font-delius-unicase	Delius Unicase
font-della-respira	Della Respira
font-delugia-book	Cascadiaコード + オタクフォント,Caskaydia Coveオタクフォントのわずかな違い
font-delugia-complete	Cascadiaコード + オタクフォント,Caskaydia Coveオタクフォントのわずかな違い
font-delugia-mono-complete	Cascadiaコード + オタクフォント,Caskaydia Coveオタクフォントのわずかな違い
font-delugia-mono-powerline	Cascadiaコード + Nerdフォント,Caskaydia Cove Nerdフォントのマイナーな違い
font-delugia-powerline	Cascadiaコード + Nerdフォント,Caskaydia Cove Nerdフォントのマイナーな違い
font-denk-one	Denk One
font-devicons	Devicons
font-devonshire	Devonshire
font-dhurjati	Dhurjati
font-dhyana	Dhyana
font-didact-gothic	Didact Gothic
font-digital-numbers	Digital Numbers
font-digohweli-old-do	Digohweli Old DO
font-diphylleia	水に触れると花びらが透明になる不思議な花
font-diplomata	Diplomata
font-diplomata-sc	Diplomata SC
font-dm-mono	DM Mono
font-dm-sans	DM Sans
font-dm-serif-display	DM Serif Display
font-dm-serif-text	DM Serif Text
font-do-hyeon	Do Hyeon
font-dokdo	Dokdo
font-domine	Domine
font-donegal-one	Donegal One
font-dongle	Dongle
font-doppio-one	Doppio One
font-dorsa	Dorsa
font-dosis	Dosis
font-dotgothic16	DotGothic16
font-doulos-sil	ラテン文字とキリル文字を使用する言語をサポートする Unicode ベースのフォント ファミリ
font-dr-sugiyama	Dr Sugiyama
font-dream-han-sans	さまざまなウェイトを備えたPan-CJK font families
font-droid-sans-mono-for-powerline	Droid Sans Mono for Powerline
font-droid-sans-mono-nerd-font	DroidSansMonoオタクフォント(Droid Sans Mono)
font-duru-sans	Duru Sans
font-dynalight	Dynalight
font-dynapuff	DynaPuff
font-eagle-lake	Eagle Lake
font-east-sea-dokdo	East Sea Dokdo
font-eater	Eater
font-eb-garamond	1592バーナー標本に基づくGaramond書体
font-ebh	Exeter Bookのスクリプトに基づくベクトル化されたフォント
font-economica	Economica
font-eczar	Eczar
font-edlo	Edlo
font-edu-nsw-act-cursive	Edu NSW ACT Cursive
font-edu-nsw-act-foundation	Edu NSW ACT Foundation
font-edu-nsw-act-hand	Edu NSW ACT Hand
font-edu-nsw-act-hand-pre	Edu NSW ACT Hand Pre
font-edu-qld-beginner	Edu QLDビギナー
font-edu-qld-hand	Edu QLD Hand
font-edu-sa-beginner	Edu SAビギナー
font-edu-sa-dotted-guide	Edu SA点線ガイド
font-edu-sa-hand	Edu SA Hand
font-edu-sa-hand-cursive	Edu SA手書き筆記体
font-edu-tas-beginner	Edu TASビギナー
font-edu-vic-wa-nt-beginner	Edu VIC WA NTビギナー
font-edu-vic-wa-nt-guide	Edu VIC WA NT Guide
font-edu-vic-wa-nt-hand	Edu VIC WA NT Hand
font-edu-vic-wa-nt-hand-pre	Edu VIC WA NT Hand Pre
font-edu-vic-wa-nt-pre-guide	Edu VIC WA NT Pre Guide
font-edwin	楽譜のテキストフォント
font-el-messiri	El Messiri
font-electrolize	Electrolize
font-elice-digital-baeum	Elice Digital Baeum
font-elsie	Elsie
font-elsie-swash-caps	Elsie Swash Caps
font-elstobd	ElstobD
font-emblema-one	Emblema One
font-emilys-candy	Emilys Candy
font-encode-sans	Encode Sans
font-encode-sans-condensed	Encode Sans Condensed
font-encode-sans-expanded	Encode Sans Expanded
font-encode-sans-sc	Encode Sans SC
font-encode-sans-semi-condensed	Encode Sans Semi Condensed
font-encode-sans-semi-expanded	Encode Sans Semi Expanded
font-engagement	Engagement
font-englebert	Englebert
font-enriqueta	Enriqueta
font-envy-code-r	Envy Code R
font-envy-code-r-nerd-font	多数のグリフを含む開発者向けのフォント
font-ephesis	カジュアルな招待状に最適な現代的なスクリプト カード/チューブ/スクラップブッキング
font-epilogue	ウェイト軸を持つSans serif可変フォント
font-erica-one	Erica One
font-escumasia	escumasiaに触発された古代の生物学スタイルのフォント
font-esteban	Esteban
font-estonia	エストニアの東ヨーロッパの国で見られる書道のスタイルに基づいています
font-et-book	Edward Tufte Book
font-euphoria-script	Euphoria Script
font-everson-mono	Everson Mono
font-ewert	Ewert
font-exo	Exo
font-exo-2	Exo 2
font-expletus-sans	Expletus Sans
font-explora	スワッシュフォームの美しい書道書体
font-ezra-sil	Ezra SIL
font-fahkwang	Fahkwang
font-fairfax	Fairfax
font-familjen-grotesk	現代的な外観のSans serif書体
font-fandol	Fandol
font-fantasque-sans-mono	Fantasque Sans Mono
font-fantasque-sans-mono-nerd-font	FantasqueSansMonoオタクフォント(Fantasque Sans Mono)
font-fantasque-sans-mono-noloopk	Fantasque Sans Mono NoLoopK
font-fanwood-text	Fanwood Text
font-farro	Farro
font-farsan	Farsan
font-fascinate	Fascinate
font-fascinate-inline	Fascinate Inline
font-faster-one	Faster One
font-fasthand	Fasthand
font-fauna-one	Fauna One
font-faune	Faune
font-faustina	Faustina
font-federant	Federant
font-federo	Federo
font-felipa	Felipa
font-fenix	Fenix
font-festive	Festive
font-figtree	Webやモバイルアプリで使用する為のクリーンで親しい幾何学的なsans serif font
font-finger-paint	Finger Paint
font-finlandica	Finlandica
font-fira-code	プログラミング合字付きのfree等幅フォント
font-fira-code-nerd-font	多数のglyphsを含む開発者向けのフォント
font-fira-mono	Fira Mono
font-fira-mono-for-powerline	Fira Mono for Powerline
font-fira-mono-nerd-font	FiraMono Nerd Font(Fira)
font-fira-sans	Fira Sans
font-fira-sans-condensed	Fira Sans Condensed
font-fira-sans-extra-condensed	Fira Sans Extra Condensed
font-firago	FiraGO
font-firge	Fira MonoとGenshinゴシックをベースにしたプログラミングフォント
font-firgenerd	Fira MonoとGenshinゴシックをベースにしたプログラミングフォント
font-fjalla-one	Fjalla One
font-fjord-one	Fjord One
font-flamenco	Flamenco
font-flavors	Flavors
font-fleur-de-leah	フローラルフレーバーのフォーマルスクリプト
font-flow-block	Flow Block
font-flow-circular	Flow Circular
font-flow-rounded	Flow Rounded
font-foldit	グラデーションを使用して次元と空間感覚で楽しむフォント
font-fondamento	Fondamento
font-fontawesome	アイコンセットとツールキット
font-fontdiner-swanky	Fontdiner Swanky
font-forum	Forum
font-foundation-icons	Foundation Icons
font-foundry-sterling	Foundry Sterling
font-fragment-mono	Helveticaに影響を受けた等幅コーディングフォント
font-francois-one	Francois One
font-frank-ruhl-libre	Frank Ruhl Libre
font-fraunces	4軸可変フォント
font-freckle-face	Freckle Face
font-fredericka-the-great	Fredericka the Great
font-fredoka	ben nathanが率いる イスラエルを拠点とするタイパーデザイン製造所
font-free-mono-tengwar	Unicode tengwar等幅フォント
font-freefont	FreeFont
font-freehand	Freehand
font-fresca	Fresca
font-frijole	Frijole
font-fruktur	Fruktur
font-fugaz-one	Fugaz One
font-fuggles	洗練された商業デザインに使用できる強力なスクリプト
font-fuzzy-bubbles	子供のパーティーに最適
font-fzfangsong-z02	Fangzheng Fangsong GBK
font-fzkai-z03	Fangzheng Kaiti GBK
font-fzshusong-z01	Fangzheng Shusong GBK
font-fzxiaobiaosong-b05	Fangzheng Xiaobiaosong GBK
font-gabarito	通常から黒までの6つのウェイトを備えた幾何学的な書体
font-gabriela	Gabriela
font-gaegu	Gaegu
font-gafata	Gafata
font-gajraj-one	Gajraj One
font-galada	Galada
font-galdeano	Galdeano
font-galindo	Galindo
font-gamja-flower	Gamja Flower
font-gandhi-sans	Gandhi Sans
font-gantari	すべてのキャラクターが調和して見える様に設計されています
font-gasoek-one	Gasoek One
font-gayathri	Gayathri
font-geist	Sans-serif書体
font-geist-mono	コードを表す場所で使用する為に設計された等幅書体
font-geist-mono-nerd-font	開発者向けのグリフ数が多いフォント
font-gelasio	Gelasio
font-gemunu-libre	Gemunu Libre
font-genjyuugothic	Gen Jyuu Gothic
font-genjyuugothic-l	Weak-Rounded version of Gen Shin Gothic
font-genjyuugothic-x	Gen Jyuu GothicX
font-genos	未来的な雰囲気のモダンなディスプレイフォント
font-genryumin	GenRyuMin
font-gensekigothic	GenSekiGothic
font-gensenrounded	GenSenRounded
font-genshingothic	Gen Shin Gothic
font-gentium-basic	Gentium Basic
font-gentium-book-basic	Gentium Book Basic
font-gentium-book-plus	縮小された文字セットファミリの新しいバージョン gentium book basic
font-gentium-plus	Gentium
font-genwanmin	GenWanMin
font-genyogothic	GenYoGothic
font-genyomin	GenYoMin
font-geo	Geo
font-geologica	Geologica
font-georama	幾つかの幅とウェイトで利用可能なオリジナルの書体
font-georgia	Georgia
font-geostar	Geostar
font-geostar-fill	Geostar Fill
font-germania-one	Germania One
font-gfs-didot	GFS Didot
font-gfs-neohellenic	GFS Neohellenic
font-gideon-roman	Gideon Roman
font-gidole	Gidole
font-gidugu	Gidugu
font-gilbert	Gilbert
font-gilda-display	Gilda Display
font-girassol	Girassol
font-give-you-glory	Give You Glory
font-glass-antiqua	Glass Antiqua
font-glegoo	Glegoo
font-gloock	細い線と太い線の滑らかな関係
font-gloria-hallelujah	Gloria Hallelujah
font-glory	ロゴに適しています 利用可能な6つのウエイトを持つ見出しと本文
font-glow-sans-j-compressed	Glow Sans J Compressed
font-glow-sans-j-condensed	Glow Sans J Condensed
font-glow-sans-j-extended	Glow Sans J Extended
font-glow-sans-j-normal	Glow Sans J Normal
font-glow-sans-j-wide	Glow Sans J Wide
font-glow-sans-sc-compressed	Glow Sans SC Compressed
font-glow-sans-sc-condensed	Glow Sans SC Condensed
font-glow-sans-sc-extended	Glow Sans SC Extended
font-glow-sans-sc-normal	Glow Sans SC Normal
font-glow-sans-sc-wide	Glow Sans SC Wide
font-glow-sans-tc-compressed	Glow Sans TC Compressed
font-glow-sans-tc-condensed	Glow Sans TC Condensed
font-glow-sans-tc-extended	Glow Sans TC Extended
font-glow-sans-tc-normal	Glow Sans TC Normal
font-glow-sans-tc-wide	Glow Sans TC Wide
font-gluten	Filling, we'll put it that way
font-gnu-unifont	GNU Unifont
font-go	Go
font-go-mono-nerd-font	GoMono Nerd Font(Go)
font-goblin-one	Goblin One
font-gochi-hand	Gochi Hand
font-gohufont-nerd-font	GohuFontオタクフォント(Gohu)
font-goldman	ポスター用に設計されたラテンのディスプレイ書体
font-golos-text	Golos Text
font-gorditas	Gorditas
font-gothic-a1	Gothic A1
font-gotu	Gotu
font-goudy-bookletter-1911	ガウディの小冊子 1911
font-gowun-batang	Gowun Batang
font-gowun-dodum	Gowun Dodum
font-graduate	Graduate
font-grand-hotel	Grand Hotel
font-grandiflora-one	Grandiflora One
font-grandstander	ウェイト軸を使用して可変フォントを表示する
font-grape-nuts	1800年代後半にさかのぼる有名な朝食用シリアルから派生
font-gravitas-one	Gravitas One
font-great-vibes	Great Vibes
font-grechen-fuemen	太いウェイトと細いウェイトを非正統的に使用した遊び心のあるフォント
font-grenze	Grenze
font-grenze-gotisch	Grenze Gotisch
font-grey-qo	Grey Qo
font-griffy	Griffy
font-gruppo	Gruppo
font-gudea	Gudea
font-gugi	Gugi
font-gulzar	オリジナルのラテン版が設計されたNasta'liqタイプ
font-gupter	Gupter
font-gurajada	Gurajada
font-gwendolyn	Gwendolyn
font-habibi	Habibi
font-hachi-maru-pop	手書きフォント
font-hack	Hack
font-hack-nerd-font	Hackオタクフォント(Hack)
font-hackgen	HackとGenJyuu-Gothicで構成される日本語プログラミングフォント
font-hackgen-nerd	HackとGenJyuu-Gothicで構成される日本語プログラミングフォント
font-hahmlet	あらゆる種類の植字に最適、プリントまたはスクリーン
font-halant	Halant
font-hammersmith-one	Hammersmith One
font-han-nom-a	HAN NOM A
font-hanalei	Hanalei
font-hanalei-fill	Hanalei Fill
font-hanamina	HanaMinA
font-handjet	ハンドジェットプリンターでうまく機能する様に調整されたフォント
font-handlee	Handlee
font-hanken-grotesk	アルフレド・マルコ・プラディル率いる
font-hannari	Hannari
font-hanuman	Hanuman
font-happy-monkey	Happy Monkey
font-harano-aji	日本語フォント(Adobe-Japan1(AJ1)CIDを使用したSource Hanフォント)
font-harmattan	Harmattan
font-hasklig	等幅合字のコードフォント
font-hasklug-nerd-font	Hasklugオタクフォント(Hasklig)
font-headland-one	Headland One
font-heavy-data-nerd-font	HeavyData Nerd Font(Heavy Data)
font-hedvig-letters-sans	そうでないときは完璧
font-hedvig-letters-serif	そうでないときは完璧
font-heebo	Heebo
font-henny-penny	Henny Penny
font-hepta-slab	Hepta Slab
font-hermeneus-one	Hermeneus One
font-hermit	明確で実用的で非常に読みやすいように設計された等幅フォント
font-herr-von-muellerhoff	Herr Von Muellerhoff
font-hi-melody	Hi Melody
font-hina-mincho	Hina Mincho
font-hind	Hind
font-hind-colombo	Hind Colombo
font-hind-guntur	Hind Guntur
font-hind-jalandhar	Hind Jalandhar
font-hind-kochi	Hind Kochi
font-hind-madurai	Hind Madurai
font-hind-mysuru	Hind Mysuru
font-hind-siliguri	Hind Siliguri
font-hind-vadodara	Hind Vadodara
font-holtwood-one-sc	Holtwood One SC
font-homemade-apple	自家製リンゴ
font-homenaje	Homenaje
font-honk	taresh vohraとチームek typeによって行われました
font-hubballi	非公式で親しみやすい外観のMonolinear書体
font-hubot-sans	GitHubのバリアブルフォントHubot Sans
font-humor-sans	Humor Sans
font-hurmit-nerd-font	Hurmit Nerd Font(Hermit)
font-hurricane	Hurricane
font-hyppolit	Hyppolit
font-ia-writer-duo	iA Writer Duo
font-ia-writer-mono	iA Writer Mono
font-ia-writer-quattro	iA Writer Quattro
font-iansui	Klee Oneから派生した中国語フォント
font-ibarra-real-nova	Ibarra Real Nova
font-ibm-plex	IBM Plex
font-ibm-plex-mono	IBM Plex Mono
font-ibm-plex-sans	IBM Plex Sans
font-ibm-plex-sans-arabic	IBM PlexSans アラビア
font-ibm-plex-sans-condensed	IBM Plex Sans Condensed
font-ibm-plex-sans-devanagari	IBM Plex Sans Devanagari
font-ibm-plex-sans-hebrew	IBM PlexSans ヘブライ
font-ibm-plex-sans-jp	IBM Plex Sans JP
font-ibm-plex-sans-kr	IBM Plex Sans KR
font-ibm-plex-sans-thai	IBM Plex Sans Thai
font-ibm-plex-sans-thai-looped	IBM Plex Sans Thai Looped
font-ibm-plex-serif	IBM Plex Serif
font-iceberg	Iceberg
font-iceland	Iceland
font-icomoon	IcoMoon
font-im-fell-double-pica	IM Fell Double Pica
font-im-fell-double-pica-sc	IM Fell Double Pica SC
font-im-fell-dw-pica	IM Fell DW Pica
font-im-fell-dw-pica-sc	IM Fell DW Pica SC
font-im-fell-english	IM Fell English
font-im-fell-english-sc	IM Fell English SC
font-im-fell-french-canon	IM Fell French Canon
font-im-fell-french-canon-sc	IM Fell French Canon SC
font-im-fell-great-primer	IM Fell Great Primer
font-im-fell-great-primer-sc	IM Fell Great Primer SC
font-im-fell-types	IM Fell Types
font-im-writing-nerd-font	iMWritingオタクフォントファミリー(iA Writer)
font-imbue	可変凝縮 Didone font
font-iming	TrueTypeの繁体字中国語書体
font-impact	Impact
font-imperial-script	きれいな接続とエレガントな外観の正式なスクリプトフォント
font-imprima	Imprima
font-inclusive-sans	Contemporary neo-grotesques
font-inconsolata	Inconsolata
font-inconsolata-dz-for-powerline	Inconsolata-dz for Powerline
font-inconsolata-for-powerline	Inconsolata for Powerline
font-inconsolata-for-powerline-bold	Inconsolata Bold for Powerline
font-inconsolata-g	Inconsolata-g
font-inconsolata-g-for-powerline	Inconsolata-g for Powerline
font-inconsolata-go-nerd-font	InconsolataGoオタクフォント(Inconsolata Go)
font-inconsolata-lgc	Inconsolata LGC
font-inconsolata-lgc-nerd-font	InconsolataLGCオタクフォント(Inconsolata LGC)
font-inconsolata-nerd-font	Inconsolataオタクフォント(Inconsolata)
font-inder	Inder
font-indie-flower	Indie Flower
font-infini	Infini
font-ingrid-darling	遊び心のある、気まぐれな魅力を持つ筆記体の手書きスタイルに基づいています
font-inika	Inika
font-inknut-antiqua	Inknut Antiqua
font-input	Input
font-inria	Inria
font-inria-sans	Inria Sans
font-inria-serif	Inria Serif
font-inspiration	Inspiration
font-instrument-sans	Instrument Sans
font-instrument-serif	Instrument Serif
font-intel-one-mono	表現力豊かな等幅フォントファミリー
font-inter	Inter
font-inter-tight	Inter Tight
font-intone-mono-nerd-font	多数のグリフを含む開発者向けのフォント
font-iosevka	Sans-serif/slab-serif/monospace/quasi‑proportional 書体ファミリー
font-iosevka-aile	Sans-serif/slab-serif/monospace/quasi‑proportional 書体ファミリー
font-iosevka-comfy	デフォルトとは異なるスタイルとメトリックを使用したIosevkaのカスタムビルド
font-iosevka-curly	Sans-serif/slab-serif/monospace/quasi‑proportional 書体ファミリー
font-iosevka-curly-slab	Sans-serif/slab-serif/monospace/quasi‑proportional 書体ファミリー
font-iosevka-etoile	Sans-serif/slab-serif/monospace/quasi‑proportional 書体ファミリー
font-iosevka-nerd-font	Iosevkaオタクフォント(Iosevka)
font-iosevka-slab	Sans-serif/slab-serif/monospace/quasi‑proportional 書体ファミリー
font-iosevka-ss01	Sans-serif/slab-serif/monospace/quasi‑proportional 書体ファミリー
font-iosevka-ss02	Sans-serif/slab-serif/monospace/quasi‑proportional 書体ファミリー
font-iosevka-ss03	Sans-serif/slab-serif/monospace/quasi‑proportional 書体ファミリー
font-iosevka-ss04	Sans-serif/slab-serif/monospace/quasi‑proportional 書体ファミリー
font-iosevka-ss05	Sans-serif/slab-serif/monospace/quasi‑proportional 書体ファミリー
font-iosevka-ss06	Sans-serif/slab-serif/monospace/quasi‑proportional 書体ファミリー
font-iosevka-ss07	Sans-serif/slab-serif/monospace/quasi‑proportional 書体ファミリー
font-iosevka-ss08	Sans-serif/slab-serif/monospace/quasi‑proportional 書体ファミリー
font-iosevka-ss09	Sans-serif/slab-serif/monospace/quasi‑proportional 書体ファミリー
font-iosevka-ss10	Sans-serif/slab-serif/monospace/quasi‑proportional 書体ファミリー
font-iosevka-ss11	Sans-serif/slab-serif/monospace/quasi‑proportional 書体ファミリー
font-iosevka-ss12	Sans-serif/slab-serif/monospace/quasi‑proportional 書体ファミリー
font-iosevka-ss13	Sans-serif/slab-serif/monospace/quasi‑proportional 書体ファミリー
font-iosevka-ss14	Sans-serif/slab-serif/monospace/quasi‑proportional 書体ファミリー
font-iosevka-ss15	Sans-serif/slab-serif/monospace/quasi‑proportional 書体ファミリー
font-iosevka-ss16	Sans-serif/slab-serif/monospace/quasi‑proportional 書体ファミリー
font-iosevka-ss17	Sans-serif/slab-serif/monospace/quasi‑proportional 書体ファミリー
font-iosevka-ss18	Sans-serif/slab-serif/monospace/quasi‑proportional 書体ファミリー
font-iosevka-term-nerd-font	多数のグリフを含む開発者向けのフォント
font-iosevka-term-slab-nerd-font	開発者向けのグリフ数が多いフォント
font-ipaexfont	IPAex Fonts
font-ipafont	IPA Fonts
font-ipamjmincho	IPAmj明朝
font-iranian-sans	Iranian Sans
font-iranian-serif	Iranian Serif
font-irish-grover	Irish Grover
font-island-moments	Island Moments
font-istok-web	Istok Web
font-italiana	Italiana
font-italianno	Italianno
font-itim	Itim
font-jaapokki	Jaapokki
font-jacquard-12	Jacquard 12
font-jacquard-12-charted	Jacquard 12 Charted
font-jacquard-24	Jacquard 24
font-jacquard-24-charted	Jacquard 24 Charted
font-jacquarda-bastarda-9	Jacquarda Bastarda 9
font-jacquarda-bastarda-9-charted	Jacquarda Bastarda 9 Charted
font-jacques-francois	Jacques Francois
font-jacques-francois-shadow	Jacques Francois Shadow
font-jaini	ジャイナ教のカルパスートラ写本の書体に基づいた書体
font-jaini-purva	ジャイナ教のカルパスートラ写本の書体に基づいた書体
font-jaldi	Jaldi
font-jaro	ヤロスラフ・ベンダの作品にインスピレーションを得たグローバル表示書体
font-jeju-gothic	Jeju Gothic
font-jeju-hallasan	Jeju Hallasan
font-jeju-myeongjo	Jeju Myeongjo
font-jersey-10	Jersey 10
font-jersey-10-charted	Jersey 10 Charted
font-jersey-15	Jersey 15
font-jersey-15-charted	Jersey 15 Charted
font-jersey-20	Jersey 20
font-jersey-20-charted	Jersey 20 Charted
font-jersey-25	Jersey 25
font-jersey-25-charted	Jersey 25 Charted
font-jetbrains-mono	開発者向けに作られた書体
font-jetbrains-mono-nerd-font	JetBrainsMonoオタクフォント(JetBrains Mono)
font-jf-open-huninn	ピンクの丸い jf open
font-jim-nightshade	Jim Nightshade
font-joan	Under development
font-jockey-one	Jockey One
font-jolly-lodger	Jolly Lodger
font-jomhuria	Jomhuria
font-jomolhari	Jomolhari
font-joscelyn	Joscelyn
font-josefin-sans	Josefin Sans
font-josefin-slab	Josefin Slab
font-jost	Jost
font-joti-one	Joti One
font-jsmath-cmbx10	jsMath-cmbx10
font-jsmath-cmex10	jsMath cmex10
font-jsmath-cmmi10	jsMath cmmi10
font-jsmath-cmr10	jsMath cmr10
font-jsmath-cmsy10	jsMath cmsy10
font-jsmath-cmti10	jsMath cmti10
font-jua	Jua
font-judson	Judson
font-julee	Julee
font-juliamono	Juliaでのプログラミング用に設計された等幅フォント
font-julius-sans-one	Julius Sans One
font-junction	Junction
font-junge	Junge
font-junicode	Junicode
font-jura	Jura
font-just-another-hand	Just Another Hand
font-just-me-again-down-here	Just Me Again Down Here
font-k2d	K2D
font-kablammo	Kablammo
font-kadwa	Kadwa
font-kaisei-decol	漢字と同じ要素でデザインされたストロークの終わりにある小さな点
font-kaisei-harunoumi	Kaisei 春の海
font-kaisei-opti	モダンな和文書体
font-kaisei-tokumin	読みやすさを維持しながらさらに大胆な書体としての力を発揮する様に設計されています
font-kaiso	現代の幻想的な日本語フォント
font-kalam	Kalam
font-kalnia	Kalnia
font-kalnia-glaze	Kalnia Glaze
font-kameron	Kameron
font-kanit	Kanit
font-kanjistrokeorders	6500字以上の漢字の書き順図 180以上のかな記号とラテン文字
font-kantumruy-pro	work sansより 幅とウエイトを変更
font-kapakana	2 つのウェイトのフォントで、静的インスタンスとしても可変フォントとしても使用可能
font-karantina	ライト/レギュラー/ボールド を含む3つのウェイトファミリー
font-karla	Karla
font-karla-tamil-inclined	Karla Tamil 傾斜
font-karla-tamil-upright	Karla Tamil Upright
font-karma	Karma
font-katibeh	Katibeh
font-kaushan-script	Kaushan Script
font-kavivanar	Kavivanar
font-kavoon	Kavoon
font-kawkab-mono	Kawkab Mono
font-kay-pho-du	kayah li スクリプトのフォントファミリー
font-kdam-thmor-pro	プロジェクトでラテン語対応として使用されます
font-keania-one	Keania One
font-kelly-slab	Kelly Slab
font-kenia	Kenia
font-khand	Khand
font-khmer	Khmer
font-khula	Khula
font-khyay	Khyay
font-kimberella	kimberellaに触発された古代生物学スタイルのフォント
font-kings	3セットのフォントファミリーに基づく kings honor/kings quest/kings dominion
font-kirang-haerang	Kirang Haerang
font-kite-one	Kite One
font-kiwi-maru	日常や俗語の表現を視覚化する為の書体
font-klee-one	Klee One
font-knewave	Knewave
font-ko-pub-batang	Ko Pub Batang
font-kodchasan	Kodchasan
font-kode-mono	Kode Mono
font-koh-santepheap	本文用のKhmerフォント
font-koho	KoHo
font-kokoro	心
font-kolker-brush	コピーを編集するときにすべて大文字を使用することはお勧めしません
font-konkhmer-sleokchher	見出しや大きなタイポグラフィでの使用に最適
font-kosugi	Available as kosugi maru
font-kosugi-maru	Available as kosugi
font-kotta-one	Kotta One
font-koulen	Koulen
font-kranky	Kranky
font-kreon	Kreon
font-kristi	Kristi
font-krona-one	Krona One
font-krub	Krub
font-kufam	現代の情報デザインを目的としたArabic-Latinのバイリンガル書体
font-kulim-park	Kulim Park
font-kumar-one	Kumar One
font-kumbh-sans	幾何学的なsans-serif多目的フォント
font-kurale	Kurale
font-la-belle-aurore	La Belle Aurore
font-labrada	Labrada
font-lacquer	Lacquer
font-laila	Laila
font-lakki-reddy	Lakki Reddy
font-lalezar	Lalezar
font-lancelot	Lancelot
font-langar	非公式で遊び心のある文字形式に基づくワンウェイトlatin/gurmukhi表示フォント
font-langdon	Langdon
font-last-resort	専用フォント Unicode文字のタイプを表すglyphsを提供する
font-last-resort-high-efficiency	Unicode文字のタイプを表すglyphsを提供する
font-lateef	Lateef
font-latin-modern	Latin Modern
font-latin-modern-math	Latin Modern Math
font-lato	Lato
font-lavishly-yours	魅力的な書道スクリプト
font-league-gothic	古い古典の復活 代替ゴシック＃1
font-league-mono	FiraMonoに触発されたMonospace書体 Libertinus Mono/Courier
font-league-script	League Script
font-league-spartan	ATFの古典的なSpartanの幾何学的なsans-serif再生
font-leckerli-one	Leckerli One
font-ledger	Ledger
font-lekton	Lekton
font-lekton-nerd-font	Lekton Nerd Font(Lekton)
font-lemon	Lemon
font-lemonada	Lemonada
font-lemonada-vf-beta	Lemonada VF Beta
font-lexend	8つのウェイトの範囲を持つフォントbureauによって拡張されました
font-lexend-deca	Lexend Deca
font-lexend-exa	Lexend Exa
font-lexend-giga	Lexend Giga
font-lexend-mega	Lexend Mega
font-lexend-peta	Lexend Peta
font-lexend-tera	Lexend Tera
font-lexend-zetta	Lexend Zetta
font-liberation	Liberation
font-liberation-mono-for-powerline	Literation Mono for Powerline
font-liberation-nerd-font	Literation Nerdフォントファミリー(解放)
font-libertinus	19世紀の本のタイプに触発されたプロポーショナルserif書体
font-libre-barcode-128	Libre Barcode 128
font-libre-barcode-128-text	Libre Barcode 128 Text
font-libre-barcode-39	Libre Barcode 39
font-libre-barcode-39-extended	Libre Barcode 39 Extended
font-libre-barcode-39-extended-text	Libre Barcode 39 Extended Text
font-libre-barcode-39-text	Libre Barcode 39 Text
font-libre-barcode-ean13-text	ドイツのニュルンベルクに拠点を置くフォント及びWeb開発者、lasse fisterが率いる
font-libre-baskerville	Libre Baskerville
font-libre-bodoni	Libre Bodoni
font-libre-caslon-display	Libre Caslonディスプレイ
font-libre-caslon-text	Libre Caslonテキスト
font-libre-franklin	Libre フランクリン
font-licorice	完璧なスクラップブッキングカード/招待状/楽しいイベント
font-life-savers	ライフセーバー
font-liga-comic-mono	プログラミング合字を備えた読みやすい等幅フォント
font-ligature-symbols	合字記号
font-lilex	Lilex
font-lilex-nerd-font	多数のグリフを含む開発者向けのフォント
font-lilita-one	Lilita One
font-lily-script-one	Lily Script One
font-limelight	Limelight
font-linden-hill	Linden Hill
font-linefont	中小規模の折れ線グラフを描画する為の可変フォント
font-linux-biolinum	Linux Biolinum
font-linux-libertine	Linux Libertine
font-lisu-bosa	Lisu Bosa
font-literata	Literata
font-liu-jian-mao-cao	Liu Jian Mao Cao
font-livvic	Livvic
font-lobster	Lobster
font-lobster-two	Lobster Two
font-lohit	Lohit
font-lohit-bengali	Lohit Bengali
font-lohit-tamil	Lohit Tamil
font-londrina-outline	Londrina Outline
font-londrina-shadow	Londrina Shadow
font-londrina-sketch	Londrina Sketch
font-londrina-solid	Londrina Solid
font-long-cang	Long Cang
font-lora	Lora
font-love-light	Adaptation of another font
font-love-ya-like-a-sister	Love Ya Like A Sister
font-loved-by-the-king	Loved by the King
font-lovers-quarrel	Lovers Quarrel
font-luckiest-guy	Luckiest Guy
font-luculent	Luculent
font-lugrasimo	書道文字スタイルの書体
font-lumanosimo	表現力豊かな書体
font-lunasima	変調のないデザイン(“sans serif”)
font-lusitana	Lusitana
font-lustria	Lustria
font-luxurious-roman	一貫性のないserifを含む半手書きフォント
font-luxurious-script	豪華なスクリプト
font-lxgw-bright	Ysabeau OfficeとLXGW WenKaiのフォントを統合
font-lxgw-bright-gb	Ysabeau Officeと LXGW WenKai GBのフォントを統合
font-lxgw-bright-tc	Ysabeau Officeと LXGW WenKai TCのフォントを統合
font-lxgw-fasmartgothic	IPAex Gothicから派生した中国語のsans-serif font
font-lxgw-heartserif	IPAmj明朝から派生した中国語sans-serif font
font-lxgw-neoxihei	IPAex Gothic から派生した中国語のsans-serif font
font-lxgw-neozhisong	IPAmj明朝から派生した中国語sans-serif font
font-lxgw-wenkai	FontworksのKlee Oneから派生したオープンソースの中国語フォント
font-lxgw-wenkai-lite	FontworksのKlee Oneから派生したオープンソースの中国語フォント
font-lxgw-wenkai-tc	FontworksのKlee Oneから派生したオープンソースの繁体字中国語フォント
font-lxgw-zhenkai	LXGW WenKaiのBolder-weightエディション
font-m-plus-1	M PLUS 1
font-m-plus-1-code	M PLUS 1 Code
font-m-plus-1p	M PLUS 1p
font-m-plus-2	M PLUS 2
font-m-plus-code-latin	M PLUS Code Latin
font-ma-shan-zheng	Ma Shan Zheng
font-macondo	Macondo
font-macondo-swash-caps	Macondo Swash Caps
font-mada	Mada
font-madimi-one	Madimi One
font-magra	Magra
font-maiden-orange	Maiden Orange
font-maitree	Maitree
font-major-mono-display	Major Mono Display
font-makinas4	感情のない直線形状のフォント
font-mako	Mako
font-mali	Mali
font-mallanna	Mallanna
font-mamelon	電子機器用の日常的なスタイルの丸いゴシックフォント
font-mandali	Mandali
font-manjari	Manjari
font-manrope	Manrope
font-mansalva	Mansalva
font-manuale	Manuale
font-maple	角が丸いNerd Fontフォント
font-marcellus	Marcellus
font-marcellus-sc	Marcellus SC
font-marck-script	Marck Script
font-margarine	Margarine
font-marhey	楽しい表示書体コントラストストロークのカスタムハンドレタリング
font-markazi-text	現代的で読みやすい書体
font-marko-one	Marko One
font-marmelad	Marmelad
font-martel	Martel
font-martel-sans	Martel Sans
font-martian-mono	Evil Martians の等幅フォント
font-martian-mono-nerd-font	開発者向けのグリフ数が多いフォント
font-marvel	Marvel
font-masinahikan	Masinahikan
font-masinahikan-dene	Masinahikan Dene
font-mate	Mate
font-mate-sc	Mate SC
font-material-design-icons-webfont	マテリアルデザインアイコンのWebフォント
font-material-icons	Material Icons
font-material-symbols	可変フォントとしてマテリアルデザインの原則に基づいたアイコン
font-maven-pro	Maven Pro
font-maven-pro-vf-beta	Maven Pro VF Beta
font-mclaren	McLaren
font-mea-culpa	繁栄した首都を持つ美しい正式なスクリプト
font-meddon	Meddon
font-medievalsharp	MedievalSharp
font-medula-one	Medula One
font-meera-inimai	Meera Inimai
font-megrim	Megrim
font-meie-script	Meie Script
font-meltho	Meltho Fonts
font-mengshen-regular	同綴異義語をサポートするオープンソースのピンインフォント
font-menlo-for-powerline	Menlo for Powerline
font-meow-script	6つのスタイルセットの幾つかの代替フォームを備えたMonolineフォント
font-merge-one	Merge One
font-merienda	Merienda
font-merriweather	Merriweather
font-merriweather-sans	Merriweather Sans
font-mervale-script	Mervale Script
font-meslo-for-powerlevel10k	Powerlevel10k用にカスタマイズされた等幅フォント
font-meslo-for-powerline	Meslo for Powerline
font-meslo-lg	Meslo LG
font-meslo-lg-dz	MesloLGフォントDotted-zeroの変種
font-meslo-lg-nerd-font	MesloLGオタクフォントファミリー(Meslo LG)
font-metal	Metal
font-metal-mania	Metal Mania
font-metamorphous	Metamorphous
font-metrophobic	Metrophobic
font-metropolis	モダンで幾何学的な書体
font-miama	Miama
font-miao-unicode	MiaoUnicode
font-michroma	Michroma
font-micro-5	プロジェクトのどこにでも収まる小さな書体
font-micro-5-charted	Micro 5 Charted
font-migmix-1m	MigMix 1M
font-migmix-1p	MigMix 1P
font-migmix-2m	MigMix 2M
font-migmix-2p	MigMix 2P
font-migu-1c	Migu 1C
font-migu-1m	Migu 1M
font-migu-1p	Migu 1P
font-migu-2m	Migu 2M
font-milonga	Milonga
font-miltonian	Miltonian
font-miltonian-tattoo	Miltonian Tattoo
font-mina	Mina
font-mingzat	jasonglavyのjglepchaカスタムエンコードフォントに基づくUnicodeフォント
font-miniver	Miniver
font-miriam-libre	Miriam Libre
font-miriam-mono-clm	Miriam Mono CLM
font-mirza	Mirza
font-miss-fajardose	Miss Fajardose
font-mitr	Mitr
font-mochiy-pop-one	Mochiy Pop One
font-mochiy-pop-p-one	Mochiy Pop P One
font-modak	Modak
font-modern-antiqua	Modern Antiqua
font-mogra	Mogra
font-mohave	Mohave
font-moirai-one	Moirai One
font-molengo	Molengo
font-molle	Molle
font-mona-sans	GitHubの可変フォントMona Sans
font-monaspace	コード用フォントのスーパーファミリー
font-monaspace-nerd-font	開発者向けのグリフ数が多いフォント
font-monda	Monda
font-monocraft	Minecraftで使用される書体に基づくプログラミング フォント
font-monocraft-nerd-font	Nerdグリフを追加するパッチが適用されたMinecraft書体に影響された等幅フォント
font-monofett	Monofett
font-monofur-for-powerline	monofur for Powerline
font-monofur-nerd-font	Monofur オタクフォント(Monofur)
font-monoid	Monoid
font-monoid-nerd-font	Monoid オタクフォント(Monoid)
font-monoisome	Monoisome
font-monomaniac-one	等幅フォントのムードでフォントを表示
font-mononoki	Mononoki
font-mononoki-nerd-font	Mononokiオタクフォント(Mononoki)
font-monoton	Monoton
font-monsieur-la-doulaise	ラ・ドゥレーズ氏
font-montaga	Montaga
font-montagu-slab	ウェイト軸と光学サイズ軸を備えた可変フォントとして利用可能
font-montecarlo	華やかな外観と読みやすいメッセージに最適
font-montez	Montez
font-montserrat	Montserrat
font-montserrat-alternates	Montserrat Alternates
font-montserrat-subrayada	Montserrat Subrayada
font-moo-lah-lah	Moo Lah Lah
font-mooli	フォントファミリから派生
font-moon-dance	Moon Dance
font-moul	Moul
font-moulpali	Moulpali
font-mountains-of-christmas	Mountains of Christmas
font-mouse-memoirs	Mouse Memoirs
font-mplus	M+ FONTS
font-mplus-nerd-font	mplus Nerd Font(M+)
font-mr-bedfort	Mr Bedfort
font-mr-dafoe	Mr Dafoe
font-mr-de-haviland	Mr De Haviland
font-mrs-saint-delafield	Mrs Saint Delafield
font-mrs-sheppards	Mrs Sheppards
font-ms-madi	このフォントをすべて大文字で使用することは決して良い考えではありません
font-mukta	Mukta
font-mukta-mahee	Mukta Mahee
font-mukta-malar	Mukta Malar
font-mukta-vaani	Mukta Vaani
font-mukti-narrow	Mukti Narrow
font-mulish	最低限のsans serif書体 表示とテキストの体裁の為に設計されています
font-murecho	9つの実用的なウェイトと可変フォントで利用可能
font-museo	Museo
font-museomoderno	MuseoModerno
font-my-soul	微妙に装飾された大文字の形をしたフラットペン書道スタイル
font-myanmar-sans-pro	ミャンマー Sans Pro
font-mynerve	Mynerve
font-myrica	Myrica
font-myricam	MyricaM
font-mystery-quest	Mystery Quest
font-n-gage	N-Gage
font-nabla	isometricコンピューターゲームに影響されたカラーフォント colrv1形式を使用して構築
font-namdhinggo	Namdhinggo
font-nanum-brush-script	Nanum Brush Script
font-nanum-gothic	Nanum Gothic
font-nanum-gothic-coding	Nanum Gothic Coding
font-nanum-myeongjo	Nanum Myeongjo
font-nanum-pen-script	Nanum Pen Script
font-narnoor	積極的に復活した
font-national-park	National Park
font-nats	NATS
font-neonderthaw	ネオンをシミュレートするシングルウェイトスクリプト
font-nerko-one	Chunky ‘marker’エフェクトフォント
font-neucha	Neucha
font-neuton	Neuton
font-new-rocker	New Rocker
font-new-tegomin	New Tegomin
font-new-york	AppleによるSerif font "New York"
font-news-cycle	News Cycle
font-newsreader	主に画面上で継続的に読むことを目的としたオリジナルの書体
font-nico-moji	Nico Moji
font-niconne	Niconne
font-nikukyu	Nikukyu
font-nimbus-sans-l	Nimbus Sans L
font-niramit	Niramit
font-nixie-one	Nixie One
font-nobile	Nobile
font-nokora	Nokora
font-norican	Norican
font-nosifer	Nosifer
font-nosifer-caps	Nosifer Caps
font-notable	Notable
font-nothing-you-could-do	あなたにできることは何もない
font-noticia-text	Noticia Text
font-noto-color-emoji	Noto カラー絵文字
font-noto-color-emoji-compat-test	Notoカラー絵文字互換性テスト
font-noto-emoji	Noto 絵文字
font-noto-kufi-arabic	Noto Kufi アラビア
font-noto-mono	Noto Mono
font-noto-mono-for-powerline	Noto Mono for Powerline
font-noto-music	Noto Music
font-noto-naskh-arabic	Noto Naskh アラビア
font-noto-naskh-arabic-ui	Noto Naskh アラビア UI
font-noto-nastaliq-urdu	Noto Nastaliq ウルドゥー
font-noto-nerd-font	Noto オタクフォントファミリー(Noto)
font-noto-rashi-hebrew	Noto Rashi ヘブライ
font-noto-sans	Noto Sans
font-noto-sans-adlam	Noto Sans Adlam
font-noto-sans-adlam-unjoined	Noto Sans Adlam Unjoined
font-noto-sans-anatolian-hieroglyphs	Noto Sans アナトリア象形文字
font-noto-sans-arabic	Noto Sans アラビア
font-noto-sans-arabic-ui	Noto Sans アラビア UI
font-noto-sans-armenian	Noto Sans アルメニア
font-noto-sans-avestan	Noto Sans Avestan
font-noto-sans-balinese	Noto Sans Balinese
font-noto-sans-bamum	Noto Sans Bamum
font-noto-sans-bassa-vah	Noto Sans Bassa Vah
font-noto-sans-batak	Noto Sans Batak
font-noto-sans-bengali	Noto Sans ベンガル
font-noto-sans-bengali-ui	Noto Sans ベンガル UI
font-noto-sans-bhaiksuki	Noto Sans Bhaiksuki
font-noto-sans-brahmi	Noto Sans Brahmi
font-noto-sans-buginese	Noto Sans Buginese
font-noto-sans-buhid	Noto Sans Buhid
font-noto-sans-canadian-aboriginal	Noto Sans Canadian Aboriginal
font-noto-sans-carian	Noto Sans Carian
font-noto-sans-caucasian-albanian	Noto Sans Caucasian Albanian
font-noto-sans-chakma	Noto Sans Chakma
font-noto-sans-cham	Noto Sans Cham
font-noto-sans-cherokee	Noto Sans Cherokee
font-noto-sans-chorasmian	歴史的な中東コラスミアン文字のデザイン
font-noto-sans-cjk	Noto Sans CJK
font-noto-sans-cjk-hk	言語固有のOTF繁体字中国語—香港(繁體中文—香港)
font-noto-sans-cjk-jp	Noto Sans CJK JP
font-noto-sans-cjk-kr	Noto Sans CJK KR
font-noto-sans-cjk-sc	Noto Sans CJK SC
font-noto-sans-cjk-tc	Noto Sans CJK TC
font-noto-sans-coptic	Noto Sans Coptic
font-noto-sans-cuneiform	Noto Sans Cuneiform
font-noto-sans-cypriot	Noto Sans Cypriot
font-noto-sans-cypro-minoan	歴史的なヨーロッパのキプロミノア文字のデザイン
font-noto-sans-deseret	Noto Sans Deseret
font-noto-sans-devanagari	Noto Sans Devanagari
font-noto-sans-devanagari-ui	Noto Sans Devanagari UI
font-noto-sans-display	Noto Sans Display
font-noto-sans-duployan	Noto Sans Duployan
font-noto-sans-egyptian-hieroglyphs	Noto Sans Egyptian Hieroglyphs
font-noto-sans-elbasan	Noto Sans Elbasan
font-noto-sans-elymaic	Noto Sans Elymaic
font-noto-sans-ethiopic	Noto Sans Ethiopic
font-noto-sans-georgian	Noto Sans Georgian
font-noto-sans-glagolitic	Noto Sans Glagolitic
font-noto-sans-gothic	Noto Sans Gothic
font-noto-sans-grantha	Noto Sans Grantha
font-noto-sans-gujarati	Noto Sans Gujarati
font-noto-sans-gujarati-ui	Noto Sans Gujarati UI
font-noto-sans-gunjala-gondi	Noto Sans Gunjala Gondi
font-noto-sans-gurmukhi	Noto Sans Gurmukhi
font-noto-sans-gurmukhi-ui	Noto Sans Gurmukhi UI
font-noto-sans-hanifi-rohingya	Noto Sans Hanifi Rohingya
font-noto-sans-hanunoo	Noto Sans Hanunoo
font-noto-sans-hatran	Noto Sans Hatran
font-noto-sans-hebrew	Noto Sans ヘブライ
font-noto-sans-hk	漢民族の表意文字の繁体字中国語の変形を使用したSans-serifデザイン
font-noto-sans-imperial-aramaic	Noto Sans Imperial Aramaic
font-noto-sans-indic-siyaq-numbers	Noto Sans Indic Siyaq Numbers
font-noto-sans-inscriptional-pahlavi	Noto Sans Inscriptional Pahlavi
font-noto-sans-inscriptional-parthian	Noto Sans Inscriptional Parthian
font-noto-sans-javanese	Noto Sans Javanese
font-noto-sans-jp	日本語用の変調されていない(“sans serif”)デザイン
font-noto-sans-kaithi	Noto Sans Kaithi
font-noto-sans-kannada	Noto Sans Kannada
font-noto-sans-kannada-ui	Noto Sans Kannada UI
font-noto-sans-kawi	歴史的な東南アジアのカウィ文字のデザイン
font-noto-sans-kayah-li	Noto Sans Kayah Li
font-noto-sans-kharoshthi	Noto Sans Kharoshthi
font-noto-sans-khmer	Noto Sans Khmer
font-noto-sans-khmer-ui	Noto Sans Khmer UI
font-noto-sans-khojki	Noto Sans Khojki
font-noto-sans-khudawadi	Noto Sans Khudawadi
font-noto-sans-kr	韓国語の変調されてい(“sans serif”)デザイン
font-noto-sans-lao	Noto Sans Lao
font-noto-sans-lao-looped	東南アジアのラオス文字のループバリアント
font-noto-sans-lao-ui	Noto Sans Lao UI
font-noto-sans-lepcha	Noto Sans Lepcha
font-noto-sans-limbu	Noto Sans Limbu
font-noto-sans-linear-a	Noto Sans Linear A
font-noto-sans-linear-b	Noto Sans Linear B
font-noto-sans-lisu	Noto Sans Lisu
font-noto-sans-lycian	Noto Sans Lycian
font-noto-sans-lydian	Noto Sans Lydian
font-noto-sans-mahajani	Noto Sans Mahajani
font-noto-sans-malayalam	Noto Sans Malayalam
font-noto-sans-malayalam-ui	Noto Sans Malayalam UI
font-noto-sans-mandaic	Noto Sans Mandaic
font-noto-sans-manichaean	Noto Sans Manichaean
font-noto-sans-marchen	Noto Sans Marchen
font-noto-sans-masaram-gondi	Noto Sans Masaram Gondi
font-noto-sans-math	Noto Sans Math
font-noto-sans-mayan-numerals	Noto Sans Mayan Numerals
font-noto-sans-medefaidrin	Noto Sans Medefaidrin
font-noto-sans-meetei-mayek	Noto Sans Meetei Mayek
font-noto-sans-mende-kikakui	Noto Sans Mende Kikakui
font-noto-sans-meroitic	Noto Sans Meroitic
font-noto-sans-miao	Noto Sans Miao
font-noto-sans-modi	Noto Sans Modi
font-noto-sans-mongolian	Noto Sans Mongolian
font-noto-sans-mono	Noto Sans Mono
font-noto-sans-mono-cjk-hk	言語固有の等幅OTF繁体字中国語—香港(繁體中文—香港)
font-noto-sans-mono-cjk-jp	言語固有の等幅OTF日本語(日本語)
font-noto-sans-mono-cjk-kr	言語固有の等幅OTF韓国語(한국어)
font-noto-sans-mono-cjk-sc	言語固有の等幅OTF簡体字中国語(简体中文)
font-noto-sans-mono-cjk-tc	言語固有の等幅OTF繁体字中国語—台湾(繁體中文—臺灣)
font-noto-sans-mro	Noto Sans Mro
font-noto-sans-multani	Noto Sans Multani
font-noto-sans-myanmar	Noto Sans Myanmar
font-noto-sans-myanmar-ui	Noto Sans Myanmar UI
font-noto-sans-n-ko	Noto Sans NKo
font-noto-sans-nabataean	Noto Sans Nabataean
font-noto-sans-nag-mundari	インド語 nag mundariスクリプトのデザイン
font-noto-sans-nandinagari	歴史的インド語ナンディナガリー文字
font-noto-sans-new-tai-lue	Noto Sans New Tai Lue
font-noto-sans-newa	Noto Sans Newa
font-noto-sans-nko	アフリカのN'Koスクリプトのテキストの調整されていないデザイン
font-noto-sans-nko-unjoined	Noto Sans NKo Unjoined
font-noto-sans-nushu	Noto Sans Nushu
font-noto-sans-ogham	Noto Sans Ogham
font-noto-sans-ol-chiki	Noto Sans Ol Chiki
font-noto-sans-old-hungarian	Noto Sans Old Hungarian
font-noto-sans-old-italic	Noto Sans Old Italic
font-noto-sans-old-north-arabian	Noto Sans Old North Arabian
font-noto-sans-old-permic	Noto Sans Old Permic
font-noto-sans-old-persian	Noto Sans Old Persian
font-noto-sans-old-sogdian	Noto Sans Old Sogdian
font-noto-sans-old-south-arabian	Noto Sans Old South Arabian
font-noto-sans-old-turkic	Noto Sans Old Turkic
font-noto-sans-oriya	Noto Sans Oriya
font-noto-sans-oriya-ui	Noto Sans Oriya UI
font-noto-sans-osage	Noto Sans Osage
font-noto-sans-osmanya	Noto Sans Osmanya
font-noto-sans-pahawh-hmong	Noto Sans Pahawh Hmong
font-noto-sans-palmyrene	Noto Sans Palmyrene
font-noto-sans-pau-cin-hau	Noto Sans Pau Cin Hau
font-noto-sans-phags-pa	Noto Sans Phags Pa
font-noto-sans-phagspa	歴史的な中央アジアのphags-pa文字テキストのSans-serif
font-noto-sans-phoenician	Noto Sans Phoenician
font-noto-sans-psalter-pahlavi	Noto Sans Psalter Pahlavi
font-noto-sans-rejang	Noto Sans Rejang
font-noto-sans-runic	Noto Sans Runic
font-noto-sans-samaritan	Noto Sans Samaritan
font-noto-sans-saurashtra	Noto Sans Saurashtra
font-noto-sans-sc	漢民族表意文字の簡体字中国語版Sans-serifデザイン
font-noto-sans-sharada	Noto Sans Sharada
font-noto-sans-shavian	Noto Sans Shavian
font-noto-sans-siddham	Noto Sans Siddham
font-noto-sans-signwriting	手話サイン台本のデザイン
font-noto-sans-sinhala	Noto Sans Sinhala
font-noto-sans-sinhala-ui	Noto Sans Sinhala UI
font-noto-sans-sogdian	Noto Sans Sogdian
font-noto-sans-sora-sompeng	Noto Sans Sora Sompeng
font-noto-sans-soyombo	Noto Sans Soyombo
font-noto-sans-sundanese	Noto Sans Sundanese
font-noto-sans-syloti-nagri	Noto Sans Syloti Nagri
font-noto-sans-symbols	Noto Sans Symbols
font-noto-sans-symbols-2	Noto Sans Symbols 2
font-noto-sans-syriac	Noto Sans Syriac
font-noto-sans-syriac-eastern	Noto Sans Syriac Eastern
font-noto-sans-syriac-estrangela	Noto Sans Syriac Estrangela
font-noto-sans-syriac-western	Noto Sans Syriac Western
font-noto-sans-tagalog	Noto Sans Tagalog
font-noto-sans-tagbanwa	Noto Sans Tagbanwa
font-noto-sans-tai-le	Noto Sans Tai Le
font-noto-sans-tai-tham	Noto Sans Tai Tham
font-noto-sans-tai-viet	Noto Sans Tai Viet
font-noto-sans-takri	Noto Sans Takri
font-noto-sans-tamil	Noto Sans Tamil
font-noto-sans-tamil-supplement	Noto Sans Tamil Supplement
font-noto-sans-tamil-ui	Noto Sans Tamil UI
font-noto-sans-tangsa	インド語tangsa文字のデザイン
font-noto-sans-tc	台湾とマカオの言語の変調されていない(“sans serif”)デザイン
font-noto-sans-telugu	Noto Sans Telugu
font-noto-sans-telugu-ui	Noto Sans Telugu UI
font-noto-sans-thaana	Noto Sans Thaana
font-noto-sans-thai	Noto Sans Thai
font-noto-sans-thai-looped	Noto Sans Thai Looped
font-noto-sans-thai-ui	Noto Sans Thai UI
font-noto-sans-tibetan	Noto Sans Tibetan
font-noto-sans-tifinagh	Noto Sans Tifinagh
font-noto-sans-tirhuta	Noto Sans Tirhuta
font-noto-sans-ugaritic	Noto Sans Ugaritic
font-noto-sans-vai	Noto Sans Vai
font-noto-sans-vithkuqi	歴史的なヨーロッパの vithkuqi文字のデザイン
font-noto-sans-wancho	Noto Sans Wancho
font-noto-sans-warang-citi	Noto Sans Warang Citi
font-noto-sans-yi	Noto Sans Yi
font-noto-sans-zanabazar-square	Noto Sans Zanabazar Square
font-noto-serif	Noto Serif
font-noto-serif-ahom	Noto Serif Ahom
font-noto-serif-armenian	Noto Serif Armenian
font-noto-serif-balinese	Noto Serif Balinese
font-noto-serif-bengali	Noto Serif Bengali
font-noto-serif-cjk	Noto Serif CJK
font-noto-serif-cjk-hk	言語固有のOTF繁体字中国語—香港(繁體中文—香港)
font-noto-serif-cjk-jp	Noto Serif CJK JP
font-noto-serif-cjk-kr	Noto Serif CJK KR
font-noto-serif-cjk-sc	Noto Serif CJK SC
font-noto-serif-cjk-tc	Noto Serif CJK TC
font-noto-serif-devanagari	Noto Serif Devanagari
font-noto-serif-display	Noto Serif Display
font-noto-serif-dogra	Noto Serif Dogra
font-noto-serif-ethiopic	Noto Serif Ethiopic
font-noto-serif-georgian	Noto Serif Georgian
font-noto-serif-grantha	Noto Serif Grantha
font-noto-serif-gujarati	Noto Serif Gujarati
font-noto-serif-gurmukhi	Noto Serif Gurmukhi
font-noto-serif-hebrew	Noto Serif Hebrew
font-noto-serif-hentaigana	かな補足、Unicodeブロックの記号を含むフォント
font-noto-serif-hk	ウェイト軸がエクストラライトからエクストラブラックまでの可変フォント
font-noto-serif-jp	日本語用の変調(“serif”)デザイン
font-noto-serif-kannada	Noto Serif Kannada
font-noto-serif-khitan-small-script	歴史的な東アジアの契丹小文字のデザイン
font-noto-serif-khmer	Noto Serif Khmer
font-noto-serif-khojki	インド語ホーキ文字のテキストの変調(“serif”)デザイン
font-noto-serif-kr	韓国語の変調(“serif”)デザイン
font-noto-serif-lao	Noto Serif Lao
font-noto-serif-makasar	歴史的な東南アジアのマカサル文字のデザイン
font-noto-serif-malayalam	Noto Serif Malayalam
font-noto-serif-myanmar	Noto Serif Myanmar
font-noto-serif-np-hmong	Noto Serif NP Hmong
font-noto-serif-nyiakeng-puachue-hmong	Noto Serif Nyiakeng Puachue Hmong
font-noto-serif-old-uyghur	歴史的な中央アジアの古いウイグル文字のデザイン
font-noto-serif-oriya	インド語のオディア(oriya)スクリプトのテキストの変調(“serif”)デザイン
font-noto-serif-ottoman-siyaq	シヤク記数体系のアラビア語形式の変調デザイン(serif)
font-noto-serif-sc	簡体字中国語の変調(“serif”)デザイン
font-noto-serif-sinhala	Noto Serif Sinhala
font-noto-serif-tamil	Noto Serif Tamil
font-noto-serif-tangut	Noto Serif Tangut
font-noto-serif-tc	台湾、香港、マカオの言語の変調(“serif”)デザイン
font-noto-serif-telugu	Noto Serif Telugu
font-noto-serif-thai	Noto Serif Thai
font-noto-serif-tibetan	Noto Serif Tibetan
font-noto-serif-toto	Noto Serif Toto
font-noto-serif-vithkuqi	歴史的なヨーロッパの vithkuqi文字のデザイン
font-noto-serif-yezidi	Noto Serif Yezidi
font-noto-traditional-nushu	Noto Traditional Nushu
font-noto-znamenny-musical-notation	Noto Znamenny 楽譜
font-nova-cut	Nova Cut
font-nova-flat	Nova Flat
font-nova-mono	Nova Mono
font-nova-oval	Nova Oval
font-nova-round	Nova Round
font-nova-script	Nova Script
font-nova-slim	Nova Slim
font-nova-square	Nova Square
font-ntr	NTR
font-numans	Numans
font-nunito	Nunito
font-nunito-sans	Nunito Sans
font-nuosu-sil	Nuosu SIL
font-ocr	OCR
font-odibee-sans	Odibee Sans
font-odor-mean-chey	Odor Mean Chey
font-office-code-pro	Office Code Pro
font-offside	Offside
font-ofl-sorts-mill-goudy-tt	OFLはMill Goudy TTをソートします
font-oi	さまざまな言語で使用されるInterjection
font-ojuju	極光から大胆まで、さまざまな絞りで特徴を発揮
font-old-standard-tt	Old Standard TT
font-oldenburg	Oldenburg
font-ole	Ole
font-oleo-script	Oleo スクリプト
font-oleo-script-swash-caps	Oleo スクリプト Swash Caps
font-onest	モダンな書体なので便利な機能がたくさんあります
font-oooh-baby	Oooh Baby
font-open-dyslexic	OpenDyslexic
font-open-dyslexic-nerd-font	OpenDyslexicオタクフォントファミリ(OpenDyslexic)
font-open-iconic	Open Iconic
font-open-sans	Open Sans
font-open-sans-hebrew	Open Sans Hebrew
font-open-sans-hebrew-condensed	Open Sans Hebrew Condensed
font-oppo-sans	OPPO Sans
font-optician-sans	Optician Sans
font-oranienbaum	Oranienbaum
font-orbit	暗い背景に明るい文字を10pt未満で使用することをお勧めします
font-orbitron	Orbitron
font-oregano	Oregano
font-orelega-one	Orelega One
font-orienta	Orienta
font-original-surfer	Original Surfer
font-ostrich-sans	Ostrich Sans
font-oswald	Oswald
font-otomanopee-one	Otomanopee One
font-outfit	Outfit
font-over-the-rainbow	Over the Rainbow
font-overlock	Overlock
font-overlock-sc	Overlock SC
font-overpass	Overpass
font-overpass-mono	Overpass Mono
font-overpass-nerd-font	Overpass Nerd Font(Overpass)
font-ovo	Ovo
font-oxanium	Oxanium
font-oxygen	Oxygen
font-oxygen-mono	Oxygen Mono
font-pacifico	Pacifico
font-padauk	Padauk
font-padyakke-expanded-one	Padyakke Expanded One
font-palanquin	Palanquin
font-palanquin-dark	Palanquin Dark
font-palette-mosaic	Palette Mosaic
font-pangolin	Pangolin
font-paprika	Paprika
font-parisienne	Parisienne
font-passero-one	Passero One
font-passion-one	Passion One
font-passions-conflict	Passions Conflict
font-pathway-extreme	非常に人気のある歴史的なタイポグラフィスタイル
font-pathway-gothic-one	Pathway Gothic One
font-patrick-hand	Patrick Hand
font-patrick-hand-sc	Patrick Hand SC
font-pattaya	Pattaya
font-patua-one	Patua One
font-pavanam	Pavanam
font-paytone-one	Paytone One
font-peddana	Peddana
font-peralta	Peralta
font-permanent-marker	Permanent Marker
font-petemoss	ぺんてるカラーブラシを使用して作成されたフォームに触発されました
font-petit-formal-script	Petit Formal スクリプト
font-petrona	Petrona
font-phetsarath	Phetsarath
font-philosopher	Philosopher
font-photonico-code	Free/モノスペース コーティング用のslab-serifスタイルフォント
font-phudu	Phudu
font-piazzolla	メディア用のSerifフォントファミリー
font-piedra	Piedra
font-pigmo00	かわいい描画スタイルの日本語フォント
font-pigmo01	かわいい描画スタイルの日本語フォント
font-pinyon-script	Pinyonスクリプト
font-pirata-one	Pirata One
font-pixelify-sans	小さな正方形のピクセルのグリッドを使用して各文字形を作成することによって実現されます
font-plangothic	Plangothicは、CJK統一表意文字をカバーする sans-serif font
font-plaster	Plaster
font-platypi	Platypuses
font-play	Play
font-playball	Playball
font-playfair	Playfair
font-playfair-display	Playfair Display
font-playfair-display-sc	Playfair Display SC
font-playpen-sans	細いフォントから太いフォントまでの太さの範囲を持つ可変フォント
font-playwrite-co	Playwrite CO
font-playwrite-fr-trad	Playwrite FR Trad
font-playwrite-gb-s	Playwrite GB S
font-playwrite-vn	Playwrite VN
font-plemol-jp	IBM Plex Mono及びIBM Plex Sans JPから合成された日本語プログラミングフォント
font-plemol-jp-hs	IBM Plex Mono及びIBM Plex Sans JPから合成された日本語プログラミングフォント
font-plemol-jp-nf	IBM Plex Mono及びIBM Plex Sans JPから合成された日本語プログラミングフォント
font-plus-jakarta-sans	用途が広いmodern type family
font-podkova	Podkova
font-podkova-vf-beta	Podkova VF Beta
font-poetsen-one	Poetsen One
font-poiret-one	Poiret One
font-poller-one	Poller One
font-poltawski-nowy	Poltawski Nowy
font-poly	Poly
font-pompiere	Pompiere
font-ponnala	Ponnala
font-pontano-sans	ミニマルで軽量なsans serif
font-poor-story	Poor Story
font-poppins	Poppins
font-poppins-latin	PoppinsLatin
font-poprumcute	現代の昭和風の日本語フォント
font-port-lligat-sans	Port Lligat Sans
font-port-lligat-slab	Port Lligat Slab
font-porter-sans-block	Porter Sans Block
font-potta-one	ブラシレタリングに触発された文字形式を特徴とするシングルスタイルフォントファミリ
font-powerline-symbols	Powerline Symbols
font-pragati-narrow	Pragati Narrow
font-praise	カジュアル(非接続)からフォーマルなアピールまでのバリエーションを持つ用途の広いスクリプト
font-prata	Prata
font-preahvihear	Preahvihear
font-press-start-2p	Press Start 2P
font-pretendard	すべてのプラットフォームのsystem-uiの代替フォント
font-pretendard-jp	すべてのプラットフォームのsystem-uiの代替フォント
font-pretendard-std	すべてのプラットフォームのsystem-uiの代替フォント
font-pridi	Pridi
font-princess-sofia	Princess Sofia
font-prociono	Prociono
font-profont-nerd-font	ProFont オタクフォントファミリー(ProFont)
font-profontx	ProFontX
font-proggy-clean-tt-nerd-font	ProggyCleanTT オタクフォントファミリー(ProggyCleanTT)
font-prompt	Prompt
font-prosto-one	Prosto One
font-protest-guerrilla	strikeのStencilバージョン
font-protest-revolution	抗議革命
font-protest-riot	抗議暴動
font-protest-strike	堅実だが穏やかな、sans serif書体
font-proza-libre	Proza Libre
font-pt-mono	PT Mono
font-pt-sans	PT Sans
font-pt-sans-caption	PT Sans Caption
font-pt-sans-narrow	PT Sans Narrow
font-pt-serif	PT Serif
font-pt-serif-caption	PT Serif Caption
font-public-sans	Public Sans
font-puppies-play	遊び心のある流れを与えるコネクタを備えた楽しく弾力のあるスクリプト
font-puritan	Puritan
font-purple-purse	Purple Purse
font-pushster	Pushster
font-qahiri	Qahiri
font-quando	Quando
font-quantico	Quantico
font-quattrocento	Quattrocento
font-quattrocento-sans	Quattrocento Sans
font-questrial	Questrial
font-quicksand	Quicksand
font-quintessential	Quintessential
font-qwigley	Qwigley
font-qwitcher-grypen	少しエッジのあるカジュアルなブラッシュスクリプト
font-racing-sans-one	Racing Sans One
font-radio-canada	Radio Canada
font-radley	Radley
font-rajdhani	Rajdhani
font-rakkas	Rakkas
font-raleway	エレガントなsans-serifフォントファミリー 現在は9つのウェイトとイタリックスタイル
font-raleway-dots	Raleway Dots
font-ramabhadra	Ramabhadra
font-ramaraja	Ramaraja
font-rambla	Rambla
font-rammetto-one	Rammetto One
font-rampart-one	Rampart One
font-ranchers	Ranchers
font-rancho	Rancho
font-ranga	Ranga
font-rasa	Rasa
font-rationale	Rationale
font-ravi-prakash	Ravi Prakash
font-readex-pro	可変フォントのファミリー
font-recursive	アロータイプを筆頭にブルックリンに拠点を置く活字製造所、ニューヨーク、アメリカ
font-recursive-code	Recursiveのビルド済みのテキストエディターに適したファイル powerline glyphsを含む
font-recursive-mono-nerd-font	開発者向けのグリフ数が多いフォント
font-red-hat-display	Red Hat Display
font-red-hat-mono	Red Hat Mono
font-red-hat-text	Red Hat Text
font-red-rose	ポスター用に設計されたラテンのディスプレイ書体
font-redacted	Redacted
font-redacted-script	Redacted スクリプト
font-reddit-mono	reddit sans及びreddit sansの圧縮によって補完されます
font-reddit-sans	Reddit sans Condensed及びReddit Monoによって補完されます
font-reddit-sans-condensed	reddit sans及びreddit monoによって補完されます
font-redhat	Red Hat
font-redressed	Redressed
font-reem-kufi	Reem Kufi
font-reem-kufi-fun	Also the name of khaled's daughter
font-reem-kufi-ink	Also the name of khaled's daughter
font-reenie-beanie	Reenie Beanie
font-reggae-one	Reggae One
font-rem	rapid eye movementの頭字語
font-rethink-sans	Sans-serif type family
font-revalia	Revalia
font-rhodium-libre	Rhodium Libre
font-ribeye	Ribeye
font-ribeye-marrow	Ribeye Marrow
font-ricty-diminished	Ricty Diminished
font-righteous	Righteous
font-risque	Risque
font-road-rage	Return to the days of grunge
font-roboto	機械的な骨格とフォームを備えたフォントは主に幾何学的です
font-roboto-condensed	Roboto Condensed
font-roboto-flex	Roboto Flex
font-roboto-mono	Roboto Mono
font-roboto-mono-for-powerline	Roboto Mono for Powerline
font-roboto-mono-nerd-font	RobotoMonoオタクフォント(RobotoMono)
font-roboto-serif	プリント媒体での読み取りと作業も同様に快適です
font-roboto-slab	Roboto Slab
font-rochester	Rochester
font-rock-3d	Rock 3D
font-rock-salt	Rock Salt
font-rocknroll-one	RocknRoll One
font-rokkitt	Rokkitt
font-rokkitt-vf-beta	Rokkitt VF Beta
font-romanesco	Romanesco
font-ronde	Kaisoをベースにした拡張ラウンドフォント
font-ropa-sans	Ropa Sans
font-rosario	Rosario
font-rosarivo	Rosarivo
font-rouge-script	Rouge Script
font-rounded-mplus	Rounded M+
font-routed-gothic	Routed Gothic
font-rowdies	Rowdies
font-rozha-one	Rozha One
font-rubik	Rubik
font-rubik-80s-fade	Rubik 80s Fade
font-rubik-beastly	グーグルフォントに基づくrubik by hubert and fischer, meir sadan and cyreal
font-rubik-broken-fax	Rubik壊れたファックス
font-rubik-bubbles	Rubik Bubbles
font-rubik-burned	Rubik Burned
font-rubik-dirt	Rubik Dirt
font-rubik-distressed	Rubik Distressed
font-rubik-doodle-shadow	Rubik落書きの影
font-rubik-doodle-triangles	Rubik落書きの三角形
font-rubik-gemstones	Rubik Gemstones
font-rubik-glitch	Rubik Glitch
font-rubik-glitch-pop	Rubik Glitch Pop
font-rubik-iso	Rubik Iso
font-rubik-lines	Rubikライン
font-rubik-maps	Rubikマップ
font-rubik-marker-hatch	Rubik Marker Hatch
font-rubik-maze	Rubik Maze
font-rubik-microbe	Rubik Microbe
font-rubik-mono-one	Rubik Mono One
font-rubik-moonrocks	Rubik Moonrocks
font-rubik-one	Rubik One
font-rubik-pixels	Rubik Pixels
font-rubik-puddles	Rubik Puddles
font-rubik-scribble	Rubik落書き
font-rubik-spray-paint	Rubik Spray Paint
font-rubik-storm	Rubik Storm
font-rubik-vinyl	Rubik Vinyl
font-rubik-wet-paint	Rubik Wet Paint
font-ruda	Ruda
font-rufina	Rufina
font-ruge-boogie	Ruge Boogie
font-ruluko	Ruluko
font-rum-raisin	Rum Raisin
font-ruslan-display	Ruslan Display
font-russo-one	Russo One
font-ruthie	Ruthie
font-ruwudu	rubutun kanoスタイルを使用するアラビア文字言語のオープンフォントファミリ
font-rye	Rye
font-sacramento	Sacramento
font-sahitya	Sahitya
font-sail	Sail
font-saira	Saira
font-saira-condensed	Saira Condensed
font-saira-extra-condensed	Saira Extra Condensed
font-saira-semi-condensed	Saira Semi Condensed
font-saira-stencil-one	Saira Stencil One
font-salsa	Salsa
font-sanchez	Sanchez
font-sancreek	Sancreek
font-sans-forgetica	Sans Forgetica
font-sansation	Sansation
font-sansita	Sansita
font-sansita-one	Sansita One
font-sansita-swashed	ヴィンテージ形式の美しい表示フォント
font-sarabun	Sarabun
font-sarala	Sarala
font-sarasa-gothic	IosevkaとSource Han Sansに基づくCJKプログラミングフォント
font-sarina	Sarina
font-sarpanch	Sarpanch
font-sassy-frass	Sassy Frass
font-satisfy	Satisfy
font-sauce-code-pro-nerd-font	SauceCodeProオタクフォント(ソースコードプロ)
font-sawarabi-gothic	さわらびゴシック
font-sawarabi-mincho	さわらび明朝
font-scada	Scada
font-scheherazade	Scheherazade
font-scheherazade-new	古典的なアラビアンナイト物語のヒロインにちなんで名付けられました
font-schibsted-grotesk	ユーザーインターフェイス用に作成されたデジタルファーストフォントファミリー
font-schoolbell	Schoolbell
font-scope-one	Scope One
font-seaweed-script	Seaweed Script
font-secular-one	Secular One
font-sedan	Sedan
font-sedan-sc	Sedan SC
font-sedgwick-ave	Sedgwick Ave
font-sedgwick-ave-display	Sedgwick Ave Display
font-sen	Sen
font-send-flowers	年配の視聴者に適しています
font-sevillana	Sevillana
font-seymour-one	Seymour One
font-sf-arabic	Appleによる"San Francisco"のアラビア語拡張
font-sf-armenian	Appleによる"San Francisco"アルメニア語拡張
font-sf-compact	Appleによる"San Francisco"のコンパクト版
font-sf-georgian	Appleによる"San Francisco"グルジア語拡張
font-sf-hebrew	Appleによる"San Francisco"のヘブライ語拡張
font-sf-mono	Appleによる"San Francisco"の等幅版
font-sf-mono-for-powerline	Powerlineをサポートする為にNerdFontsパッチャーでパッチされたAppleのSFMonoフォント
font-sf-pro	Appleによる”San Francisco"のSans-serifバージョン
font-shadows-into-light	Shadows Into Light
font-shadows-into-light-two	Shadows Into Light Two
font-shalimar	平らなペン先の書道のストロークに触発された直立したスクリプト
font-shantell-sans	Shantell Sans
font-shanti	Shanti
font-share	Share
font-share-tech	Share Tech
font-share-tech-mono	Share Tech Mono
font-shippori-antique	Shippori Antique
font-shippori-antique-b1	Shippori Antique B1
font-shippori-mincho	東京の築地書体製作施設をベースに
font-shippori-mincho-b1	東京の築地書体製作施設をベースに
font-shizuru	Shizuru
font-shojumaru	Shojumaru
font-short-stack	Short Stack
font-shrikhand	Shrikhand
font-shure-tech-mono-nerd-font	ShureTechMonoオタクフォント(Share Tech Mono)
font-siemreap	Siemreap
font-sigmar	Sigmar
font-sigmar-one	Sigmar One
font-signika	優しいキャラクターのSans-serif看板書体
font-signika-negative	Signika Negative
font-signika-negative-sc	Signika SCフォントの代替バージョン
font-signika-sc	SignikaフォントのSmall-capsバージョン
font-silkscreen	あなたのWebグラフィック書体
font-simonetta	Simonetta
font-simple-line-icons	Simple Line Icons
font-single-day	Single Day
font-sintony	Sintony
font-sirin-stencil	Sirin Stencil
font-sitara	Sitara
font-six-caps	Six Caps
font-sixtyfour	Sixtyfour
font-skranji	Skranji
font-slabo-13px	Slabo 13px
font-slabo-27px	Slabo 27px
font-slackey	Slackey
font-slackside-one	手書き表示フォント
font-smiley-sans	人間主体と幾何学の視覚的バランスを追求した中国語書体
font-smokum	Smokum
font-smooch	他の手書きのスクリプトよりも少し大胆
font-smooch-sans	Smooch Sans
font-smythe	Smythe
font-sn-pro	SN Proは、Markdownでの使用に最適化された使いやすいsans serif書体です
font-sniglet	Sniglet
font-snippet	Snippet
font-snowburst-one	Snowburst One
font-sofadi-one	Sofadi One
font-sofia	Sofia
font-sofia-sans	Sofia Sans
font-sofia-sans-condensed	Sofia Sans Condensed
font-sofia-sans-extra-condensed	Sofia Sans Extra Condensed
font-sofia-sans-semi-condensed	Sofia Sans Semi Condensed
font-solitreo	過去の遺物 言語のほとんどの作家がローマ字を使用するため
font-solway	Solway
font-sometype-mono	Sometype Mono
font-song-myung	Song Myung
font-sono	固定幅(そして明らかに調整されてない)
font-sonsie-one	Sonsie One
font-sora	Sora
font-sorts-mill-goudy	MillGoudyを並べ替えます
font-souliyo	Souliyo
font-source-code-pro	ソースコードプロ
font-source-code-pro-for-powerline	PowerlineのソースコードPro
font-source-sans-3	ソース Sans 3
font-source-serif-4	Source Serif 4
font-space-grotesk	Space Grotesk
font-space-mono	Space Mono
font-space-mono-nerd-font	SpaceMonoオタクフォント(Space Mono)
font-special-elite	Special Elite
font-spectral	Spectral
font-spectral-sc	Spectral SC
font-spicy-rice	Spicy Rice
font-spinnaker	Spinnaker
font-spirax	Spirax
font-splash	Splash
font-spleen	Spleen
font-spline-sans	spline teamによって開始された元の書体
font-spline-sans-mono	スプラインチームによって開始された元の書体
font-squada-one	Squada One
font-square-peg	Square Peg
font-sree-krushnadevaraya	Sree Krushnadevaraya
font-sriracha	Sriracha
font-srisakdi	Srisakdi
font-staatliches	Staatliches
font-stalemate	Stalemate
font-stalinist-one	Stalinist One
font-stardos-stencil	Stardos Stencil
font-stick	キュートで遊び心のある直線デザイン
font-stick-no-bills	Sinhalaとラテン文字をサポートするStencil styleの書体
font-stint-ultra-condensed	Stint Ultra Condensed
font-stint-ultra-expanded	Stint Ultra Expanded
font-stix	科学用のUnicodeフォント テクニカル/数学のテキスト
font-stix-two-math	STIX Two Math
font-stix-two-text	STIX Two Text
font-stoke	Stoke
font-strait	Strait
font-strong	Strong
font-style-script	外観がカジュアルからフォーマルまでさまざまな直立したスクリプト
font-stylish	Stylish
font-sudo	プログラマー及びコマンドラインユーザー向けのフォント
font-sue-ellen-francisco	Sue Ellen Francisco
font-suez-one	Suez One
font-sulphur-point	Sulphur Point
font-sumana	Sumana
font-sunflower	Sunflower
font-sunshiney	Sunshiney
font-supermercado-one	Supermercado One
font-sura	Sura
font-suranna	Suranna
font-suravaram	Suravaram
font-suwannaphum	Suwannaphum
font-swanky-and-moo-moo	Swanky and Moo Moo
font-symbols-only-nerd-font	オタクフォントアイコンだけ、シンボルフォントのみ
font-syncopate	Syncopate
font-syne	もともとアートセンター'Synesthésie'の為に設計された書体
font-syne-mono	コントロールを手放す別の見方
font-syne-tactile	もともとアートセンター'Synesthésie'の為に設計されました
font-tac-one	アフロタイプのプロジェクト
font-tai-heritage-pro	通常の太字のウェイトで利用可能 OpenTypeとグラファイトレンダリングの両方で
font-tajawal	Tajawal
font-takaoex	TakaoEx
font-tangerine	Tangerine
font-tapestry	少し素朴で田舎風のRoman calligraphicファミリー
font-taprom	Taprom
font-tauri	Tauri
font-taviraj	Taviraj
font-teachers	Teachers
font-teko	Teko
font-tektur	コンパクトな組版を可能にする高めの設定
font-telex	Telex
font-tenali-ramakrishna	Tenali Ramakrishna
font-tengwar-formal-csur	CSURに準拠したTengwar Unicodeフォント
font-tengwar-telcontar	Tengwar Telcontar-Unicode Tengwarフォント
font-tenor-sans	Tenor Sans
font-terminess-ttf-nerd-font	TerminessTTFオタクフォント(Terminus)
font-terminus	Terminus TTF
font-tex-gyre-adventor	TeX Gyre Adventor
font-tex-gyre-bonum	TeX Gyre Bonum
font-tex-gyre-bonum-math	Bonum Math
font-tex-gyre-chorus	TeX Gyre Chorus
font-tex-gyre-cursor	TeX Gyre Cursor
font-tex-gyre-heros	TeX Gyre Heros
font-tex-gyre-pagella	TeX Gyre Pagella
font-tex-gyre-pagella-math	Pagella Math
font-tex-gyre-schola	TeX Gyre Schola
font-tex-gyre-schola-math	Schola Math
font-tex-gyre-termes	TeX Gyre Termes
font-tex-gyre-termes-math	Termes Math
font-text-me-one	Text Me One
font-texturina	guillermo torresによるデザイン
font-thabit	Thabit
font-tharlon	Tharlon
font-thasadith	Thasadith
font-the-girl-next-door	The Girl Next Door
font-the-nautigal	流動的でありながらフォーマルで美しいコネクタ
font-tiejili-sc	Reggae Oneを中国語にフォントワークス拡張したオープンソースのフォント
font-tienne	Tienne
font-tillana	Tillana
font-tilt-neon	Tilt Neon
font-tilt-prism	Tilt Prism
font-tilt-warp	Tilt Warp
font-times-new-roman	Times New Roman
font-times-newer-roman	Times New Romanと同じ様に見えますが、文字の幅が5〜10％広くなっています
font-timmana	Timmana
font-tinos	Tinos
font-tinos-nerd-font	Tinos Nerd Font(Tinos)
font-tiro-bangla	伝統的な文学出版に適しています
font-tiro-devanagari-hindi	より広いプロポーション、寛大なカウンターと強い斜めのストローク
font-tiro-devanagari-marathi	より広いプロポーション、寛大なカウンターと強い斜めのストローク
font-tiro-devanagari-sanskrit	より広いプロポーション、寛大なカウンターと強い斜めのストローク
font-tiro-gurmukhi	伝統的なパンジャブ原稿のストローク変調を再導入
font-tiro-kannada	伝統的な文学出版に特に適しています
font-tiro-tamil	伝統的な文学出版に特に適しています
font-tiro-telugu	伝統的な文学出版に特に適しています
font-titan-one	Titan One
font-titillium	Titillium
font-titillium-web	Titillium Web
font-togalite	M+ extended with thorn
font-tomorrow	Tomorrow
font-tourney	Completely solid
font-trade-winds	Trade Winds
font-train-one	Train One
font-trebuchet-ms	Trebuchet MS
font-trirong	Trirong
font-trispace	Designed by tyler finck(etc)
font-trocchi	Trocchi
font-trochut	Trochut
font-truculenta	包装用/ブランディング/本の表紙/イラスト版/映画のタイトル
font-trykker	Trykker
font-tsukimi-rounded	丸みを帯びた端子を備えたsans-serif書体
font-tt2020	高度なオープンソースの現実的な多言語タイプライターフォント
font-tuffy	Tuffy
font-tulpen-one	Tulpen One
font-turret-road	Turret Road
font-twilio-sans-mono	プログラミングフォント
font-twinkle-star	キュートで楽しいjuvenileスクリプト
font-twitter-color-emoji	Twitterカラー絵文字
font-typographer-woodcut-initials-one	タイポグラファーの木版画のイニシャル one
font-ubuntu	明確にする為に手動でヒントを与えられたsans-serif書体
font-ubuntu-condensed	Ubuntu Condensed
font-ubuntu-mono	Ubuntu Mono
font-ubuntu-mono-derivative-powerline	Ubuntu Mono derivative Powerline
font-ubuntu-mono-nerd-font	UbuntuMonoオタクフォント(Ubuntu Mono)
font-ubuntu-nerd-font	Ubuntuオタクフォント(Ubuntu)
font-ubuntu-sans	Ubuntu Sans
font-ubuntu-sans-mono	Ubuntu Sans Mono
font-ubuntu-sans-nerd-font	開発者向けのグリフ数が多いフォント
font-uchen	Uchen
font-udev-gothic	BIZ UD GothicとJetBrains Monoのフォントを統合する
font-udev-gothic-nf	BIZ UD GothicとJetBrains Monoのフォントを統合す
font-ultra	Ultra
font-unbounded	おそらく世界初のon-chain資金援助によるフォント
font-uncial-antiqua	Uncial Antiqua
font-undefined-medium	ピクセルグリッドベース monospace書体
font-underdog	Underdog
font-unica-one	Unica One
font-unifrakturcook	UnifrakturCook
font-unifrakturmaguntia	UnifrakturMaguntia
font-unkempt	Unkempt
font-unlock	Unlock
font-unna	Unna
font-updock	クリーンなコネクタを備えた非常に読みやすい正式なスクリプト
font-urbanist	Urbanist
font-urw-base35	URW++ base 35
font-vampiro-one	Vampiro One
font-varela	Varela
font-varela-round	Varela Round
font-varta	Varta
font-vast-shadow	Vast Shadow
font-vazirmatn	robotoと組み合わせる
font-verdana	Verdana
font-vesper-libre	Vesper Libre
font-viaoda-libre	Viaoda Libre
font-vibes	Vibes
font-vibur	Vibur
font-victor-mono	筆記体の斜体とプログラミング記号の合字を使用した等幅フォント
font-victor-mono-nerd-font	多数のglyphsを含む開発者向けのフォント
font-vidaloka	Vidaloka
font-viga	Viga
font-vina-sans	Vina Sans
font-voces	Voces
font-volkhov	Volkhov
font-vollkorn	Vollkorn
font-vollkorn-sc	Vollkorn SC
font-voltaire	Voltaire
font-vt323	VT323
font-vujahday-script	Vujahday Script
font-waiting-for-the-sunrise	日の出を待っています
font-wallpoet	Wallpoet
font-walter-turncoat	Walter Turncoat
font-waptia	Ancient-biology スタイルのフォント
font-warnes	Warnes
font-water-brush	水彩テクスチャ紙に色で満たされたCamelヘアブラシ
font-waterfall	Calligraphic script
font-wavefont	バー間の距離を調整するのに便利です、1ch === 1 bar width
font-wellfleet	Wellfleet
font-wendy-one	Wendy One
font-whisper	Whisper
font-windsong	複数の文体セットを含む細長いスクリプト
font-wire-one	Wire One
font-wix-madefor-display	Wix Madefor ディスプレイ
font-work-sans	Work Sans
font-workbench	Workbench
font-xanh-mono	lambaoとduydaoによってデザインされたMono-serif書体
font-xits	数学及び科学出版向けのタイムライクな書体
font-xkcd	xkcd
font-xkcd-script	xkcd-script
font-yaldevi	Designed by sol matas
font-yaldevi-colombo	Yaldevi Colombo
font-yanone-kaffeesatz	Yanone Kaffeesatz
font-yantramanav	Yantramanav
font-yarndings-12	Yarndings 12
font-yarndings-12-charted	Yarndings 12 Charted
font-yarndings-20	Yarndings 20
font-yarndings-20-charted	Yarndings 20 Charted
font-yatra-one	Yatra One
font-yellowtail	Yellowtail
font-yeon-sung	Yeon Sung
font-yeseva-one	Yeseva One
font-yesteryear	Yesteryear
font-yinmar	Yinmar
font-yomogi	よもぎ
font-young-serif	重量感のある古いスタイルの serif typeface
font-yrsa	Yrsa
font-ysabeau	Ysabeau
font-ysabeau-infant	Ysabeau Infant
font-ysabeau-office	Exercise in restraint
font-ysabeau-sc	Exercise in restraint
font-yuji-boku	新しくて楽しいデザイン
font-yuji-hentaigana-akari	Yuji変体仮名Akari
font-yuji-hentaigana-akebono	Yuji変体仮名Akebono
font-yuji-mai	Yuji Mai
font-yuji-syuku	Also approachable
font-yusei-magic	手書き文字をベースにした視認性の高いフォント
font-zcool-kuaile	ZCOOL KuaiLe
font-zcool-qingke-huangyou	ZCOOL QingKe HuangYou
font-zcool-xiaowei	ZCOOL XiaoWei
font-zed-mono	Iosevka に基づく準プロポーショナル等幅フォント
font-zed-mono-nerd-font	開発者向けのグリフ数が多いフォント
font-zed-sans	Iosevka に基づく準プロポーショナルsans-serifフォント
font-zen-antique	Zen Antique
font-zen-antique-soft	Zen Antique Soft
font-zen-dots	zenフォントコレクションの3つのラテンフォントの1つ
font-zen-kaku-gothic-antique	クラシックでありながらシンプルでスタイリッシュなバージョン
font-zen-kaku-gothic-new	クラシックでありながらシンプルでスタイリッシュなバージョン
font-zen-kurenaido	手書き感のある日本語フォント
font-zen-loop	yoshimichi ohiraがZenフォントコレクションの一部としてデザインしたラテンフォント
font-zen-maru-gothic	どんなシーンでも使いやすい
font-zen-old-mincho	テキストの使用を目的としており大きなサイズでもうまく機能します
font-zen-tokyo-zoo	Zen 東京 Zoo
font-zeyada	Zeyada
font-zhi-mang-xing	Zhi Mang Xing
font-zhudou-sans	NotoSansから派生したCJK記号と句読点
font-zhuque-fangsong	TrionesTypeによって作成されたオープンソースの中国語Fangsongフォント
font-zilla-slab	Zilla Slab
font-zilla-slab-highlight	Zilla Slab Highlight
1password-beta	すべてのパスワードを1つのパスワードの背後で安全に保つパスワードマネージャー
1password-cli-beta	1Passwordパスワードマネージャーのコマンドラインヘルパー
1password-cli1	1Passwordパスワードマネージャーのコマンドラインヘルパー
1password-nightly	パスワードマネージャー
1password6	すべてのパスワードを1つのパスワードで安全に保つパスワードマネージャー
1password7	すべてのパスワードを1つのパスワードで安全に保つパスワードマネージャー
ableton-live-intro10	サウンドと音楽のエディター
ableton-live-intro11	サウンド及び音楽エディター
ableton-live-lite10	サウンドと音楽のエディター
ableton-live-lite11	サウンド及び音楽エディター
ableton-live-standard10	サウンドと音楽のエディター
ableton-live-standard11	サウンド及び音楽エディター
ableton-live-suite10	サウンドと音楽のエディター
ableton-live-suite11	サウンド及び音楽エディター
ableton-live-suite9	サウンドと音楽のエディター
adguard-nightly	スタンドアロンの広告ブロッカー
adguard-vpn-nightly	プライバシーとセキュリティの為のVPN
adoptopenjdk8	ビルド済みのOpenJDKバイナリ
aerial-beta	Apple TV Aerialスクリーンセーバー
affinity-designer1	プロ仕様のグラフィックデザインソフトウェア
affinity-photo1	プロ仕様の画像編集ソフトウェア
affinity-publisher1	プロフェッショナルデスクトップパブリッシングソフトウェア
alfred2	アプリケーションランチャーと生産性ソフトウェア
alfred3	アプリケーションランチャーと生産性ソフトウェア
alfred4	アプリケーションランチャーと生産性ソフトウェア
anaconda2	データサイエンスプラットフォーム
android-studio-preview-beta	Androidアプリケーションを構築する為のツール
android-studio-preview-canary	Androidアプリケーションを構築する為のツール
arduino-ide-nightly	電子工学プロトタイピングプラットフォーム
arduino-nightly	電子プロトタイピングプラットフォーム
arq5	マルチクラウドバックアップアプリケーション
atom-beta	クロスプラットフォームのテキストエディター
atom-nightly	クロスプラットフォームのテキストエディター
azure-data-studio-insiders	SQLServerでの作業を可能にするデータ管理ツール
bbedit14	テキスト/コード/マークアップ エディター
beyond-compare-beta	ファイルとフォルダーを比較する
blender-lts	Freeのオープンソース3D作成セット
brave-browser-beta	プライバシーに焦点を当てたWebブラウザー
brave-browser-dev	プライバシーに焦点を当てたWebブラウザー
brave-browser-nightly	プライバシーに焦点を当てたWebブラウザー
buckets-beta	予算編成ツール
calibre4	電子書籍管理ソフトウェア
carbon-copy-cloner5	ハードディスクのバックアップとクローン作成ユーティリティ
charles-applejava	Webデバッグプロキシアプリケーション
chromedriver-beta	Google Chrome用のWebアプリの自動テスト
cleanmymac3	ディスクから不要なファイルとフォルダーを削除するツール
corretto11	AmazonからのOpenJDKディストリビューション
corretto17	AmazonからのOpenJDKディストリビューション
corretto21	AmazonからのOpenJDKディストリビューション
corretto8	AmazonからのOpenJDKディストリビューション
daedalus-flight	Cardanoブロックチェーン上のada用のDaedalus暗号通貨ウォレットのプレリリース
dash2	APIドキュメントブラウザとコードスニペットマネージャ
dash3	APIドキュメントブラウザとコードスニペットマネージャ
dash4	APIドキュメントブラウザとコードスニペットマネージャ
dash5	APIドキュメントブラウザとコードスニペットマネージャー
dash6	APIドキュメントブラウザとコードスニペットマネージャー
db-browser-for-sqlcipher-nightly	SQLCipher用のデータベースブラウザ
db-browser-for-sqlite-nightly	SQLite用のデータベースブラウザー
deadbeef-nightly	モジュラーオーディオプレーヤー
defold-alpha	デスクトップ開発用のゲームエンジン モバイル/Webゲーム
defold-beta	デスクトップ開発用のゲームエンジン モバイル/Webゲーム
discord-canary	音声及びテキストチャットソフトウェア
discord-development	音声及びテキストチャットソフトウェア
discord-ptb	音声及びテキストチャットソフトウェア
docker-edge	コンテナ化されたアプリケーションとマイクロサービスを構築して共有する為のアプリ
dolphin-beta	ゲームキューブやWiiのゲームが遊べるエミュレーター
dolphin-dev	ゲームキューブとWiiのゲームが遊べるエミュレーター
dotnet-preview	開発者プラットフォーム
dotnet-sdk-preview	開発者プラットフォーム
dropbox-beta	Dropboxクラウドストレージサービスのクライアント
element-nightly	マトリックスコラボレーションクライアント
elephas-beta	パーソナルAIライティングアシスタント
emacs-nightly	GNU Emacsテキストエディター
emacs-pretest	テキストエディター
figma-beta	協調的チームソフトウェア
firefox-beta	Webブラウザー
firefox-cn	中国語版Firefox
firefox-developer-edition	Webブラウザー
firefox-esr	Webブラウザー
firefox-nightly	Webブラウザー
folding-at-home-beta	科学研究の為のタンパク質特定構造シミュレーション
forklift2	Finderの代替品と FTP/SFTP/WebDAV/Amazon s3クライアント
forklift3	Finderの代替、FTP、SFTP、WebDAV、Amazon s3 クライアント
geogebra5	解決 数学の問題を保存して共有する グラフ関数等
gimp-dev	Freeでオープンソースの画像エディター
github-beta	GitHubリポジトリ用のデスクトップクライアント
godot3	ゲーム開発エンジン
google-chrome-beta	Webブラウザー
google-chrome-canary	Webブラウザー
google-chrome-dev	Webブラウザー
google-japanese-ime-dev	Google日本語入力方式エディター
gpg-suite-nightly	メールやファイルを保護する為のツール
graalvm-jdk17	OracleからGraalVM
graalvm-jdk21	OracleのGraalVM
hamsket-nightly	Freeのオープンソースメッセージング及び電子メールアプリ
hancom-word-2014	ワードプロセッサ
hyper-canary	Webテクノロジーに基づいて構築されたターミナル
inso-beta	CLI HTTP及びGraphQLクライアント
insomnia-alpha	HTTP及びGraphQLクライアント
intellij-idea-ce19	Java開発用IDE-コミュニティ版
intellij-idea-eap	IntelliJ IDEA早期アクセスプログラム
intellij-idea19	JVM言語用のIDE
istat-menus5	iStatsメニュー
iterm2-beta	Appleターミナルアプリの代替ターミナルエミュレータ
iterm2-legacy	Appleターミナルアプリの代替ターミナルエミュレータ
iterm2-nightly	Appleターミナルアプリの代替ターミナルエミュレータ
java-beta	Javaプログラミング言語用の早期アクセス開発キット
java6	Javaプログラミング言語のレガシーランタイム
julia-lts	テクニカルコンピューティングの為のプログラミング言語
julia-nightly	テクニカルコンピューティングの為のプログラミング言語
kaleidoscope2	テキストと画像のファイルまたはフォルダの違いを見つけてマージする
kaleidoscope3	テキスト及び画像ファイルまたはフォルダー内の相違点を特定してマージします
keepassxc-beta	パスワードマネージャーアプリ
keepassxc-snapshot	パスワードマネージャーアプリ
keka-beta	File archiver
keyboard-maestro8	キーボードMaestro
kitty-nightly	GPU-basedターミナルエミュレータ
ksdiff2	Kaleidoscope v2のApp Storeバージョン用のコマンドラインツール
lando-edge	Docker上に構築されたローカル開発環境とDevOpsツール
libreoffice-still	Freeのクロスプラットフォームオフィスセット
libreoffice-still-language-pack	LibreOfficeの代替言語のコレクション
little-snitch4	ホストベースのアプリケーションファイアウォール
local-beta	FlywheelによるWordPressローカル開発ツール(ベータ版)
macfuse-dev	ファイルシステム統合
macloggerdx-beta	アマチュア無線ロギング及びリグ制御ソフトウェア
mailmate-beta	IMAPメールクライアント
mi-beta	テキストエディター
microsoft-edge-beta	マルチプラットフォームのWebブラウザー
microsoft-edge-dev	マルチプラットフォームのWebブラウザー
microsoft-office-2016	オフィスセット
microsoft-office-2019	Officeセット
microsoft-openjdk11	MicrosoftからのOpenJDKディストリビューション
microsoft-openjdk17	MicrosoftからのOpenJDKディストリビューション
microsoft-teams-classic	１ヶ所で会議、チャット、通話、コラボレーションが可能
miniconda2	condaの最小限のインストーラー
mixxx-snapshot	オープンソースのDJソフトウェア
monal-beta	チャットサーバーに安全に接続する為のツール
mongodb-compass-beta	MongoDBのGUI
mono-mdk-for-visual-studio	Microsoftの.NETFrameworkのオープンソース実装
morpheus-beta	多細胞システム生物学のモデリング環境
mullvadvpn-beta	VPNクライアント
mumble-snapshot	ゲーム用のオープンソース、低遅延、高品質のボイスチャットソフトウェア
navicat-premium15	データベース管理及び開発ツール
netnewswire-beta	FreeのオープンソースRSSリーダー
obs-beta	ライブストリーミングと画面録画用のオープンソースソフトウェア
olympus	Everest(ビデオゲームCeleste用のModローダー) インストーラー/マネージャー
omegat-latest	翻訳メモリツール
omnifocus2	編成重視のスケジューリングアプリ
omnigraffle6	ビジュアルコミュニケーションソフトウェア
omniplan3	プロジェクト計画及び管理ソフトウェア
openemu-experimental	レトロなビデオゲームエミュレーション
openra-playtest	Westwoodゲーム用のリアルタイムストラテジーゲームエンジン
openscad-snapshot	プログラム可能なソリッド3D CADモデラー
openshot-video-editor-daily	クロスプラットフォームのビデオエディター
opera-beta	Webブラウザー
opera-crypto-developer	Web3ブラウザ
opera-developer	Webブラウザー
oracle-jdk17	OracleからJDK
oracle-jdk21	オラクルのJDK
papers3	あなたの個人的な研究ライブラリ
paragon-extfs11	ext2/3/4フォーマットされたボリュームの、読み取り/書き込みサポート
parallels12	デスクトップ仮想化ソフトウェア
parallels13	デスクトップ仮想化ソフトウェア
parallels14	デスクトップ仮想化ソフトウェア
parallels15	デスクトップ仮想化ソフトウェア
parallels16	デスクトップ仮想化ソフトウェア
parallels17	デスクトップ仮想化ソフトウェア
parallels18	デスクトップ仮想化ソフトウェア
pdf-expert-beta	PDFリーダー エディター/注釈
pgadmin3	PostgreSQLの管理及び開発プラットフォーム
picoscope-beta	PicoScope oscilloscops用のテスト及び測定オシロスコープソフトウェア
playcover-community-beta	iOSアプリとゲームをサイドロードする
postico1	PostgreSQLデータベースのGUIクライアント
postmancanary	API開発の為のコラボレーションプラットフォーム
powershell-preview	コマンドラインシェルとスクリプト言語
powershell6	コマンドラインシェルとスクリプト言語
processing2	柔軟なソフトウェアスケッチブックとコーディング方法を学ぶ為の言語
processing3	コーディング方法を学習する為の柔軟なソフトウェア スケッチブックと言語
propresenter-beta	ライブイベントのプレゼンテーション及び制作アプリケーション
propresenter6	ライブイベントのプレゼンテーション及び制作アプリケーション
qbittorrent-lt20	libtorrent-rasterbar 2.0.xに基づくqBitorrentのエディション
qgis-ltr	地理情報システム
qt-creator-dev	アプリケーション開発の為のIDE
quicktime-player7	ビデオプレーヤー
rambox-ce	Freeのオープンソースメッセージング及び電子メールアプ
reflector2	ワイヤレス画面ミラーリングアプリケーション
royal-tsx-beta	リモート管理ソリューション
rstudio-daily	RとPythonを中心としたデータサイエンスソフトウェア
safari-technology-preview	Webブラウザー
semeru-jdk11-open	OpenJDKクラスライブラリとEclipse OpenJ9 JVMを備えた本番環境対応のJDK
semeru-jdk17-open	OpenJDKクラスライブラリとEclipse OpenJ9 JVMを備えた本番環境対応のJDK
semeru-jdk8-open	OpenJDKクラスライブラリとEclipse OpenJ9 JVMを備えた本番環境対応のJDK
shadow-beta	オンライン仮想化コンピュータ
signal-beta	セキュリティに焦点を当てたインスタントメッセージングアプリケーション
sketch-beta	デジタルデザイン及びプロトタイピングプラットフォーム
skype-preview	ビデオチャット 音声通話とインスタントメッセージングアプリケーション
skype7	ビデオ チャット/音声通話/インスタントメッセージング アプリケーション
slack-beta	チームコミュニケーション及び協力ソフトウェア
slicer-preview	医用画像処理及び視覚化システム
smcfancontrol-beta	内蔵ファンの最低速度を設定します
sonarr-beta	sonarr-beta
sonos-s1-controller	Gen 1 Sonos製品のコントローラー
soulver2	テキストエディタと電卓
sourcetree-beta	Gitバージョン管理用のグラフィカルクライアント
sublime-merge-dev	Gitクライアント
sublime-text-dev	コード用のテキストエディタ マークアップ/散文
sublime-text2	コード用テキストエディタ マークアップ/散文
sublime-text3	コード、マークアップ、散文用のテキストエディター
surge4	ネットワークツールボックス
telegram-desktop-beta	Telegramメッセンジャー用のデスクトップクライアント
temurin11	Eclipse Foundation(Adoptium)のJDK
temurin17	Eclipse Foundation(Adoptium)のJDK
temurin18	Eclipse Foundation(Adoptium)のJDK
temurin19	Eclipse Foundation(Adoptium)のJDK
temurin20	JDK from the Eclipse Foundation (Adoptium)
temurin21	JDK from the Eclipse Foundation (Adoptium)
temurin8	Eclipse Foundation(Adoptium)のJDK
termius-beta	SSHクライアント
threema-beta	エンドツーエンドで暗号化されたインスタントメッセージングアプリケーション
thunderbird-beta	Mozilla Thunderbird
thunderbird-daily	カスタマイズ可能なメールクライアント
tor-browser-alpha	セキュリティに重点を置いたWebブラウザー
tower2	パワーと生産性に重点を置いたGitクライアント
transmission-nightly	オープンソースのBitTorrentクライアント
transmit4	ファイル転送アプリケーション
tsh13	分散インフラストラクチャを管理するチームのSSHサーバー
tunnelblick-beta	OpenVPN用のFreeオープンソースグラフィックユーザーインターフェイス
typora-dev	Markdownをサポートする構成可能なドキュメントエディター
utm-beta	QEMUを使用した仮想マシンUI
virtualbox-beta	x86及びarm64ハードウェア用のバーチャライザー
virtualbox6	x86ハードウェアのバーチャライザー
virtualbuddy-beta	仮想化ツール
visual-studio-code-insiders	コードエディター
vivaldi-snapshot	カスタマイズと制御に焦点を当てたWebブラウザー
vlc-nightly	オープンソースのクロスプラットフォームマルチメディアプレーヤー
vmware-fusion-tech-preview	仮想マシンの 実行/作成/管理
vmware-fusion10	仮想マシンの 作成/管理/実行
vmware-fusion11	再起動せずに他のオペレーティングシステムを実行するアプリ
vmware-fusion12	仮想マシンの 作成/管理/実行
vmware-fusion7	仮想マシンの 作成/管理/実行
vmware-fusion8	仮想マシンの 作成/管理/実行
vox2	外部ソースからのハイレゾ(Hi-Res)音楽用の音楽プレーヤー
vscodium-insiders	コードエディタ
wezterm-nightly	GPUで高速化されたクロスプラットフォームターミナルエミュレーター及びマルチプレクサー
whatsapp-beta	WhatsAppのデスクトップクライアント
whatsapp-legacy	WhatsApp用のデスクトップクライアント
whoozle-android-file-transfer-nightly	Androidファイル転送
wine-devel	Windowsアプリケーションを実行する為の互換性レイヤー
wine-staging	Windowsアプリケーションを実行する為の互換性レイヤー
xampp7	MySQL/PHP 7/Perl を含むApacheディストリビューション
xmind-beta	マインドマップとブレインストーミングツール
xmind8	マインドマッピングとブレーンストーミングツール
zed-preview	マルチプレイヤーコードエディター
zotero-beta	研究ソースを収集、整理、引用、共有する
zulu11	AzulからのOpenJDKディストリビューション
zulu13	AzulからのOpenJDKディストリビューション
zulu15	Zulu OpenJDK 15
zulu17	AzulからのOpenJDKディストリビューション
zulu21	AzulからのOpenJDKディストリビューション
zulu7	AzulからのOpenJDKディストリビューション
zulu8	AzulからのOpenJDKディストリビューション
